Miss Jerry| The adventures of a female reporter in the 1890s.;
The Story of the Kelly Gang| True story of notorious Australian outlaw Ned Kelly 185580.;
Den sorte drm| Two men of high rank are both wooing the beautiful and famous equestrian acrobat Stella. While Stella ignores the jeweler Hirsch, she accepts Count von Waldbergs offer to follow her home, ...;
Cleopatra| The fabled queen of Egypts affair with Roman general Marc Antony is ultimately disastrous for both of them.;
LInferno| Loosely adapted from Dantes Divine Comedy and inspired by the illustrations of Gustav Dor the original silent film has been restored and has a new score by Tangerine Dream.;
From the Manger to the Cross or, Jesus of Nazareth| An account of the life of Jesus Christ, based on the books of the New Testament After Jesus birth is foretold to his parents, he is born in Bethlehem, and is visited by shepherds and wise;
Madame DuBarry| The story of Madame DuBarry, the mistress of Louis XV of France, and her loves in the time of the French revolution.;
Quo Vadis| An epic Italian film Quo Vadis influenced many of the later movies.;
Independenta Romaniei| The movie depicts the Romanian War of Independence 18771878.;
Richard III| Richard of Gloucester uses manipulation and murder to gain the English throne.;
Atlantis| After Dr. Friedrichs wife becomes mentally unstable and his research papers are rejected, he leaves the country to respite.;
Fantmas   lombre de la guillotine| Inspector Juve is tasked to investigate and capture an infamous criminal Fantomas.;
Il calvario di una madre| Single mother is separated from her children due to financial struggles.;
Juve contre Fantmas| In Part Two of Louis Feuillades 5 12hour epic follows Fantmas, the criminal lord of Paris, master of disguise, the creeping assassin in black, as he is pursued by the equally resourceful Inspector Juve.;
Ma lamor mio non muore...| Leslie Swayne, an adventurer, in order to obtain enough money to satisfy the needs of his extravagant life, has been bribed to steal the plans of the fortification from the staff officers ...;
Maudite soit la guerre| An army pilot is on a visit at the home of another army pilot in the neighboured country. He falls in love with his sister. After the outbreak of a war between the two countries, her ...;
Le mort qui tue| After a body disappears from inside the prison, a series of crimes take place, all seemingly by the dead man. With Juve presumed dead, Fandor must investigate alone. Will Fantomas finally be brought to justice;
Amore di madre| John Howard Payne at his most miserable point in life, writes a song which becomes popular and inspires other people at some point in their lives.;
Lo studente di Praga| Balduin, a student of Prague, leaves his roystering companions in the beer garden, when he finds he has reached the end of his resources. He is scarcely seated in a quiet corner when a ...;
Traffic in Souls| A woman, with the aid of her police officer sweetheart, endeavors to uncover the prostitution ring that has kidnapped her sister, and the philanthropist who secretly runs it.;
Gli ultimi giorni di Pompei| Two love triangles intersect in ancient Pompei.;
Assunta Spina| Assunta Spina is a tragedy set in Naples at the beginning of the twentieth century. Assunta and Michele are in love but others come between them and there is much jealousy. They fight and ...;
The Avenging Conscience or Thou Shalt Not Kill| Prevented from dating his sweetheart by his uncle, a young man turns his thoughts to murder.;
The Bargain| After the bandit Jim Stokes robs the stage he is wounded fleeing. Recuperating at a ranch, he falls in love with and marries the daughter. Now wishing to go straight he tries to return the ...;
Cabiria| Cabiria is a Roman child when her home is destroyed by a volcano. Sold in Carthage to be sacrificed in a temple, is saved by Fulvio, a Roman spy. But danger lurks, and hatred between Rome and Carthage can only lead to war.;
Cinderella| Though mistreated by her cruel stepmother and stepsisters, Cinderella is able to attend the royal ball through the help of a fairy godmother.;
Lenfant de Paris| The young daughter of an army captain missing in action runs away from school and is kidnapped by Parisian lowlifes. When the kidnapper flees to Nice with the child, the kindhearted employee of one of his accomplices sets off in pursuit.;
Fantmas contre Fantmas| The mystery of the drama is the appearance of the fingerprint of a dead artist upon the neck of Princess Sonia Danidoff, whom Fantomas, as Nanteuil, relieves of her pearl necklace, and ...;
A Florida Enchantment| A young woman discovers a seed that can make women act like men and men act like women. She decides to take one, then slips one to her maid and another to her fianc. The fun begins.;
Der Golem| In this version of the golem legend, the golem, a clay statue brought to life by Rabbi Loew in 16th century Prague to save the Jews from the ongoing brutal persecution by the citys rulers,...;
Det hemmelighedsfulde X| On the brink of war, Lt. van Hauen is summoned to take command of the cruiser, but due to unforeseen events, he is wrongfully convicted as a traitor.;
His Majesty, the Scarecrow of Oz| A wicked king has taken over the Emerald City, and wants his daughter, Princess Gloria, to marry the horrid courtier GooglyGoo, though she loves Pon, the Gardeners Boy. The camera now ...;
Hypocrites| The parallel stories of a modern preacher and a medieval monk, Gabriel the Ascetic, who is killed by an ignorant mob for making a nude statue representing Truth, which is also represented by a ghostly naked girl who flits throughout the film.;
In the Land of the Head Hunters| In 1911, as part of his massive undertaking, famed Northwest photographer Edward S. Curtis travelled to Vancouver Island, British Columbia, to visit the Kwakwakawakw. By the next year, ...;
Judith of Bethulia| A religious woman seeks to save her people from destruction by seducing and murdering the enemy leader, but her plans get complicated once she falls for him.;
The Patchwork Girl of Oz| Ojo and Unc Nunkie are out of food, so they decide to journey to the Emerald City where they will never starve. Along the way, they meet Mewel, a waif and stray mule who leads them to Dr....;
The Perils of Pauline| Young Pauline is left a lot of money when her wealthy uncle dies. However, her uncles secretary has been named as her guardian until she marries, at which time she will officially take ...;
The Squaw Man| A chivalrous British officer takes the blame for his cousins embezzlement and journeys to the American West to start a new life on a cattle ranch.;
La madonnina del porto| A wealthy resident attempts to dispossess squatters who live near his home, which leads to a false accusation of murder.;
Tillies Punctured Romance| A con man from the city dupes a wealthy country girl into marriage.;
A tolonc| Betty Lili Berky, Duel For Nothing, a young woman living in the country, is told by her dying father that he is really her uncle and raised her as his own when her mother was sent to ...;
Uncle Toms Cabin| A black and white silent film based on Harriet Beecher Stowes novel documenting the life and times of Uncle Tom.;
The Virginian| A goodnatured but chivalrous cowboy romances the local schoolmarm and leads the posse that brings a gang of rustlers, which includes his best friend, to justice.;
The Wishing Ring An Idyll of Old England| After being expelled from college, Giles runs away from home and meets a young lady who he falls for.;
The Wrath of the Gods| An American sailor falls in love with a fishermans daughter and convinces her that Jesus is more powerful than the gods who have cursed her.;
Alias Jimmy Valentine| After robbing a bank, a criminal is wrongfully pardoned from prison.;
Alice in Wonderland| Alice goes with her sister to a picnic and then she falls asleep and starts dreaming about a wonderland full of talking animals and walking playing cards.;
Nascita di una nazione| The Stoneman family finds its friendship with the Camerons affected by the Civil War, both fighting in opposite armies. The development of the war in their lives plays through to Lincolns assassination and the birth of the Ku Klux Klan.;
Carmen| In order to help her smuggler kinsmen, a sultry gypsy seduces and corrupts an officer of the Civil Guard turning him into a traitor and murderer.;
The Cheat| A venal, spoiled stockbrokers wife impulsively embezzles 10,000 from the charity she chairs and desperately turns to a Burmese ivory trader to replace the stolen money.;
The Coward| Colonel Winslow, veteran of the Mexican War, hopes for a great future for his only son, Frank. At the outbreak of the Civil War, a recruiting station is opened in the Virginia village where...;
La vampira| A married diplomat falls hopelessly under the spell of a predatory woman.;
The Golden Chance| Mary Denby becomes a seamstress after her husband Steve wastes their money on booze. Her employer provides her as an escort to accompany millionaire Roger Manning. Her husband tries ...;
Hvnens Nat| A criminal escapes from prison, however a betrayal leads to his second arrest.;
The Italian| An immigrant leaves his sweetheart in Italy to find a better life across the sea in the grimy slums of New York. They are eventually reunited and marry. But life in New York is hard and ...;
Maciste| A young girl, pursued by a band of conspirators, hides in a movie theatre where she watches the film Cabiria. She determines to seek the aid of that films strongman, Maciste. When she ...;
Martyrs of the Alamo| The story of the defense of the missionturnedfortress by 185 Texans against an overwhelming Mexican army in 1836.;
The Nigger| Philip Morrow grows to manhood in the belief that the blood in his veins is the most aristocratic in the South. Clif Noyes, a distiller of whiskey of the fiery brand manufactured for ...;
Posle smerti| Andrei lives a secluded life with his aunt, studying and thinking about his nowdeceased mother. His friend Tsenin is concerned, and tries to get Andrei to accompany him to social events. ...;
Rapsodia satanica| A Faustian tale about an old woman who makes a pact with Mephisto to regain her youth, in return she must stay away from love. After the deal she meets two brothers who fall in love with her.;
La rigenerazione| A boy surrounded by violence grows up to become an infamous gangster.;
I vampiri| An intrepid reporter and his loyal friend battle a bizarre secret society of criminals known as The Vampires.;
Young Romance| Young Romance, released in 1915, is a recent rediscovery that forever silences the claim that refined comedy cannot be conveyed via the screen. This disguise plot, worthy of an Elizabethan ...;
20,000 Leagues Under the Sea| A French professor and his daughter accompany Captain Nemo on an adventure aboard a submarine.;
The Children in the House| Roy Somerville has turned out a rather interesting story that will hold the interest of the majority of audiences as produced by the TriangleFine Arts Company. It is a fivereel feature ...;
Civilization| Christ takes on the form of a pacifist count to end a senseless war.;
The Devils Needle| Wynne Mortimer, a pampered society girl and daughter of William Mortimer, a prominent business man, chances to meet David White, a young artist whose fame is already assured, at an art ...;
Ddskyssen| Dr Monro is found dead in his home. Three people are testifying before the police about what happened.;
Flirting with Fate| In the midst of an emotional depression, a man hires a murderer to kill him. But the despair soon passes, and the man must now escape the killer hes hired to end his life.;
Going Straight| A man and his wife both have criminal pasts, but have quit crime and are now respectable citizens. One day a member of their old gang shows up and threatens to expose them if they dont ...;
The Good BadMan| An outlaw calling himself Passin Through halts his evil ways long enough to help out some children in difficulty.;
Gretchen the Greenhorn| A kindly Dutch immigrant and her bumbling father are blackmailed by a gang of counterfeiters.;
The HalfBreed| An outcast named Lo Dorman encounters a young woman lost in the woods. He defends her from danger in the forest and from Sheriff Dunn.;
Hells Hinges| In the wayward western town known as Hells Hinges, a local tough guy is reformed by the faith of a good woman.;
His Picture in the Papers| A young man can only get the woman he loves if he becomes famous and manages to get his picture in the newspapers. He determines to let nothing stand in the way of his doing exactly that, ...;
Hoodoo Ann| A little orphan girl believes that her life is falling apart. It seems that everything that could possibly go wrong does go wrong. However, certain things happen that begin to make her ...;
Intolerance| The story of a poor young woman, separated by prejudice from her husband and baby, is interwoven with tales of intolerance from throughout history.;
Judex| A twelve part serial following the adventures of the masked vigilante Judex as he fights against criminals led by the corrupt banker Favrauxom.;
The Matrimaniac| A young couple attempts to elope, with the brides irate father in hot pursuit. The train stops briefly and the young man dashes off to find a minister, but before he can get himself and ...;
Pikovaya dama| While hosting a game of cards one night, Narumov tells his friends a story about his grandmother, a Countess. As a young woman, she had once incurred an enormous gambling debt, which she ...;
Reggie Mixes In| Reggie, a wealthy young man about town, is eager for excitement, so he takes to visiting the rougher sections of the city in search of thrills. He meets and falls for a cabaret singer, but ...;
The Return of Draw Egan| Outlaw leader Draw Egan, believed dead, turns up in the town of Yellow Dog. The townsfolk believe him to be William Blake, a strong and lawabiding man. They appoint him sheriff to rid ...;
Schuhpalast Pinkus| Sally Pinkus is an GermanJewish boy who takes a job as a shoe store clerk after being expelled from school for goofing around. Soon fired for trying to court the owners daughter, Pinkus ...;
Sherlock Holmes| When a couple of swindlers hold young Alice Faulkner against her will in order to discover the whereabouts of letters which could spell scandal for the royal family, Sherlock Holmes is on the case.;
Shoes| A young working girl must support her family on only five dollars  120 in 2020 a week. The strain of trying to feed, house and clothe her mother, her father and three sisters finally ...;
Snow White| Snow White is a motherless princess, who arouses the jealousy and hatred of Mary Jane, her mothers former ladyinwaiting, who is the ugliest woman in the kingdom, but aspires to the ...;
The Social Secretary| To avoid unwanted attention at her next job, a young professional disguises herself, leading to some unintended consequences.;
Vingarne| An adaptation of Herman Bangs 1902 novel Mikal. A sculptor befriends a young painter who becomes his model. Their friendship is thrown into turmoil when they both fall in love with the same woman.;
Where Are My Children| A District Attorneys outspoken stand on abortion gets him in trouble with the local community.;
4917| A retired judge comes West to restore a ghost town.;
Bucking Broadway| A ranch foreman battles a rich stockbroker for the affections of a beautiful young woman.;
Cleopatra| The story of Cleopatra, the fabulous queen of Egypt, and the epic romances between her and the greatest men of Rome, Julius Caesar and Antony.;
Furcht| After years travelling the world, Count Greven returns home with the art treasures he has collected. But his disposition has altered dramatically and he is a troubled man. Will he suffer ...;
A Girls Folly| A restless young girl yearns to leave her rural environment and get away from it all. One day she stumbles upon a film crew shooting a western near her home. She makes friends with the ...;
Lastronave| A group of researchers from Earth travel in a spaceship to Mars, where, to big surprise, they find a peaceful vegetarian and pacifist civilization.;
Joan the Woman| A WWI English officer is inspired the night before a dangerous mission by a vision of Joan of Arc, whose story he relives.;
The Little American| A young American has her ship torpedoed by a German Uboat but makes it back to ancestral home in France, where she witnesses German brutality firsthand.;
The Little Princess| Little Sara Crewe is placed in a boarding school by her father when he goes off to war, but he does not understand that the headmistress is a cruel, spiteful woman who makes life miserable ...;
Desiderata| Sad story of an unfaithful wife and her subsequent sufferings as a mother.;
A Modern Musketeer| A restless young man travels west, encountering adventure, romance, and danger.;
Otets Sergiy| Prince Kasatsky is a just and proud youth, shock and disappointment with the world bring him to church, he becomes father Sergius. It is a story of his piety and temptation.;
The Poor Little Rich Girl| The wealthy but selfish parents of a lonely young girl begin to rethink what is important to them after a servants irresponsibility results in a crisis.;
Raffles, the Amateur Cracksman| Gentleman burglar Raffles tries to get his hand on a priceless pearl.;
Rebecca of Sunnybrook Farm| With her family in financial difficulties, Rebecca is sent to live with her two strict, unfeeling aunts, who do not appreciate the young girls charm and energy. Rebecca must make new ...;
A Romance of the Redwoods| A young girl travels west to live with her uncle during the California Gold Rush only to find that he has been killed by Indians and his identity assumed by an outlaw.;
Straight Shooting| Cattleman Flint cuts off farmer Sims water supply. When Sims son Ted goes for water, one of Flints men kills him. Cheyenne is sent to finish off Sims, but finding the family at the newly dug grave, he changes sides.;
A Tale of Two Cities| Alcoholic lawyer Sydney Carton travels to Paris during the Reign of Terror to rescue French aristocrat Charles Darnay, husband of the woman he loves.;
Terje Vigen| Terje Vigen, a sailor, suffers the loss of his family through the cruelty of another man. Years later, when his enemys family finds itself dependent on Terjes beneficence, Terje must ...;
Thomas Graals bsta film| Thomas Graals a screenwriter, is very fond of his secretary Bessie. Overtaken by a kiss by Thomas she runs away. In his misfortune Thomas writes a screenplay inspired by Bessie. But she has not been really honest with him .;
Tillie Wakes Up| On the third floor of the apartment house at 003 Findlet Avenue lived Mr. and Mrs. Henry Tinkelpaw. The neighbors said it was a shame the way he neglected his poor wife, but Tillies ...;
Tom Sawyer| Tom Sawyer, a young Missouri lad, finds fun and adventure with his pals Joe Harper and Huckleberry Finn, running away to hide out on Jacksons Island and pretending to be Mississippi River ...;
Tsen frn Stormyrtorpet| Helga is a young single lady who has a baby by a much older married man. After the older man tells Helgas father that he refuses to pay child support because he isnt the childs father, ...;
Wild and Woolly| A rich young Easterner who has always wanted to live in the Wild West plans to move to a Western town. Unknown to him, the towns wild days are long gone, and it is an orderly, ...;
Amarilly of ClothesLine Alley| Amarilly comes from a large family in a workingclass neighborhood. She is happy with her family and her boyfriend Terry, a bartender in a cafe. But one day she meets Gordon, a sculptor who...;
Az aranyember| The adventures of captain Mihly Tmr, who aids a persecuted Turkish Pasha and his daughter in their escape across the Donau. After the Pasha dies, the captain acquires his fortune and ...;
Gli occhi della mummia| A girl is kidnapped and held captive in an ancient Egyptian temple. She is rescued and flees to England, but soon finds that her mysterious captor is still haunting her.;
I proscritti| A stranger comes to work at widow Hallas farm.;
Luccello blu| Two peasant children, Mytyl and Tyltyl, are led by Berylune, a fairy, to search for the Blue Bird of Happiness. Berylune gives Tyltyl a cap with a diamond setting, and when Tyltyl turns the...;
Broadway Love| A smalltown girl goes to New York hoping to become a star on Broadway, but the best she can do are roles as chorus girls. She falls in with a fast crowd, notably a party girl named ...;
Sangue gitano| The tragic story of Don Jose, a Spanish cavalryman, who falls under the spell of a gypsy girl, Carmen, who treats him with both love and contempt and leads him into temptation and thus ...;
La decima sinfonia| Composer Enrid Damor knows nothing of the past life of his new wife Eve Dinant  she lived as a debauchee with an adventurer, Fred Ryce. Fred Ryce meets Damors daughter, Claire, and tries ...;
Lallegra prigione| A neglected wife disguises herself in order to lure her wastrel husband into a compromising position.;
The Forbidden City| A Chinese mandarin hopes to regain favor with the Emporer by betrothing her to him, but he doesnt know shes secretly married to the American consul and pregnant.;
Cuori del mondo| Young lovers in a French village are torn apart with the coming of the Great War.;
Indemoniato| A cowboy must save his girlfriend from captivity and then cross the desert on foot with a single waterhole on the way.;
Johanna Enlists| A young girl, stifling on her fathers backwoods farm, is reinvigorated by the arrival of an army regiment, come to train in the area.;
MLiss| Mliss, a feisty young girl in a mining camp, falls for Charles Gray, the school teacher. Charles is implicated in a murder of which he is innocent, and the two must fight to save him from ...;
The Married Virgin| An already engaged young woman is blackmailed into marrying a count in order to save her father from imprisonment.;
Mickey| Mickey, an orphan who has been brought up in a mining settlement, is sent to New York to live with her aunt.;
Old Wives for New| Charles Murdock neglects his fat and lazy wife in favor of Juliet Raeburn but, when Juliets name is involved in murder, he marries Viola and takes her to Paris.;
A Pair of Silk Stockings| A Pair of Silk Stockings is a 1918 American silent marital comedy film starring Constance Talmadge and Harrison Ford. It was directed by Walter Edwards and produced and distributed by ...;
A Romance of Happy Valley| John Logan leaves his parents and sweetheart in bucolic Happy Valley to make his fortune in the city. Those he left behind become miserable and beleaguered in his absence, but after several...;
Shifting Sands| Marcia Grey is wrongly convicted on trumpedup evidence of a German. After serving her term, she rebuilds her life and marries well. The German then attempts to blackmail her into helping ...;
Charlot soldato| Charlie is a boot camp private who has a dream of being a hero who goes on a daring mission behind enemy lines.;
Stella Maris| Two young women  a paraplegic girl sheltered by her wealthy guardians and a more experienced orphan  fall in love with a man separated from his violent wife.;
Tarzan of the Apes| Reared by a childless ape, the orphaned heir of the Greystokes becomes one of the apes. Then, Dr Porter organises a rescue expedition, and his beautiful daughter, Jane, catches his attention. Has Tarzan of the Apes found the perfect mate;
Tih Minh| Jacques dAthys, a French adventurer, returns to his home in Nice after an expedition to Indochina where he has picked up a Eurasian fiance and a book that, unbeknownst to him, contains a ...;
The Unbeliever| A wealthy young American, bred to class distinction and racial intolerance, enters the Marines during the First World War. In the course of his training and his experiences in the trenches ...;
The Whispering Chorus| John Trimble has embezzled and obtains another identity by having a mutilated body buried in his place. He is later arrested for murdering himself. During the trial his mother, before dying...;
Anders als die Andern| Two male musicians fall in love, but blackmail and scandal makes the affair take a tragic turn.;
Ravished Armenia| Aurora Mardiganian, a young and beautiful Armenian girl, lives with her parents in the Turkish city of Harpoot. Her father, a prosperous merchant, was preparing to send her to the West to ...;
La principessa delle ostriche| An American heiress seeks the hand of an impoverished German prince.;
El automvil gris| A gang terrorizes Mexico Citys high society on 1915. Murder, kidnaping and robbery are their trademarks. One police inspector Cabrera follows the gang crimes and eventually send them to ...;
Il ritorno al paradiso terrestre| A woman finds herself all alone in a remote harbor with the man responsible for the murder of her father. With seemingly nobody around to protect her, she has to be resourceful.;
Behind the Door| A GermanAmerican naval officer takes revenge against the German submarine commander who brutalized his wife.;
Mariti ciechi| An Austrian officer sets out to seduce a neglected young wife.;
Giglio infranto| A frail waif, abused by her brutal boxer father in Londons seedy Limehouse District, is befriended by a sensitive Chinese immigrant with tragic consequences.;
The Busher| A young baseball pitcher in the bush leagues is discovered by a bigleague manager and given his chance in the major leagues. But will he be up to the challenge;
DaddyLongLegs| An orphan discovers that she has an anonymous benefactor who is willing to pay her college tuition, unaware hes the same man who has been romantically pursuing her.;
The Delicious Little Devil| A poor hatcheck girl loses her job and is forced to get a job as a dancer at a roadhouse. There she falls in love with the son of a rich businessman. The boys father, believing her to be ...;
Dont Change Your Husband| Leila Porter comes to dislike her husband James, a glue king who is always eating onions and looking sloppy. But after she divorces him and marries twotiming playboy Schuyler Van Sutphen the nowreformed James looks pretty good.;
Eyes of Youth| A young woman at a crossroads is shown what her future would be like for each choice.;
For Better, for Worse| Dr. Edward Meade and friend Richard Burton both love Sylvia Norcross. Both enlist in the military, but Meade stays back to care for deformed children. Sylvia thinks him a coward and marries...;
Getting Mary Married| A young woman must resist the charms of a handsome stranger and stay single if she wants to inherit a fortune.;
The Greatest Question| An orphan girl is given shelter by a farm family, but soon finds herself in the clutches of a murderous farmer and his wife.;
The Grim Game| Jailed unjustly for a murder he did not commit, a young man uses his amazing powers of escape to free himself and pursue the actual killers, who hold his fiance captive.;
Harakiri| The Buddhist priest wants the Daughter of the Daimyo to become a priestess at the Forbidden Garden. The Daimyo thinks if he were in Europe that his daughter should decide on her own, but he...;
Heart o the Hills| Family tensions in the Kentucky hills are inflamed by an outsiders dishonest scheme to exploit the area for its coal.;
Il tesoro di Arne| Three Scottish officers, including Sir Archi, murder Sir Arne and his household for a coffin filled with silver coins. The only survivor is Elsalill, who moves to relatives in Marstrand. ...;
The Hoodlum| A spoiled young rich girl is forced by misfortune to fight for survival in the slums and alleys, where she becomes involved with all manner of unpleasantness.;
Non vorrei essere un uomo| A teenaged tomboy, tired of being bossed around by her strict guardian, impersonates a man so she can have more fun, but discovers that being the opposite sex isnt as easy as she had hoped.;
Ingmarssnerna| LillIngmar is having a troublesome love life with his bride to be Brita.;
Per la patria| The story of two men, one married, the other the lover of the others wife, who meet in the trenches of the First World War, and how their tale becomes a microcosm for the horrors of war.;
Il gabinetto del dottor Caligari| Hypnotist Dr. Caligari uses a somnambulist, Cesare, to commit murders.;
Male and Female| Lady Mary Lasenby is a spoiled maiden who always gets her way until shipwrecked with her butler, then learns which qualities are really admirable in a person.;
Meyer il berlinese| A bumbling, selfindulgent husband goes on a vacation away from his wife. There he meets a popular, attractive young woman also on a vacation. Both go on a mountain climb which is going to be far from an ideal adventure.;
The Miracle Man| A gang of crooks evade the police by moving their operations to a small town. There the gangs leader encounters a faith healer and uses him to scam gullible public of funds for a supposed ...;
The Mother and the Law| A reedited version of the modern story from;
Die Pest in Florenz| Suddenly appearing in Florence, an evil seductress causes Cesare, the citys ruler, and his son to both fall madly in love with her. The son, killing his father before an order to torture ...;
Prsidenten| The judge in a Danish town sees his illegitimate daughter facing a trial for the murder of her newborn child, and is rather sure that she will be sentenced to death. She became pregnant ...;
La bambola di carne| Forced into marriage by his uncle, a man decides to fool him by marrying a lifelike mechanical doll instead.;
The Roaring Road| A young man pursues a young lady with the same energy he applies to his other obsession in life, auto racing.;
Scarlet Days| A romantic bandit named Alvarez, wanted for raids on the mining camps of the California gold rush in 1849, is reformed by the love of a good woman.;
The Sentimental Bloke| A downatheal exconvict undergoes an epiphany as he experiences the love of a good woman for the first time.;
Il lago doro, ovvero I ragni| Kay Hoog finds a message that indicates that some Incas are still alive, but the secret organisation Die Spinnen wants the Incas gold....;
Il canto del fiore rosso| Olof Koskela is the son of a rich farmer. He seduces young girls at random, until an inconsistent gesture rushes him away from home and his carefree lifestyle. Based on the 1905 novel by Finnish author Johannes Linnankoski.;
Amore sulle labbra| Susie, a plain young country girl, secretly loves a neighbor boy, William. She believes in him and sacrifices much of her own happiness to promote his own ambitions, all without his ...;
Un affare misterioso| A demon, a reaper, and the ghost of a prostitute read gothic short stories and act them out.;
Victory| Axel Heyst, an uncommitted wanderer, has settled on an island in the South Seas. He takes pity on a troubled young woman, Lena, and gives her refuge on her island. But the piratical Mr. ...;
Wagon Tracks| Buckskin Hamilton guides a wagon train across the wasteland, caring well for the pioneers he escorts, but hoping to solve the murder of his brother by one of the travellers.;
Quando le nuvole volano via| Psychiatrist Dr. Ulrich Metz attempts to drive Daniel Brown to suicide.;
The Wicked Darling| A slum girl is forced to steal for a living. After she swipes a rich societys matrons necklace, she hides out at the home of a man who turns out to be the socialites former fiance.;
Yankee Doodle in Berlin| Behind enemy lines, Captain Bob White disguises himself as a woman in order to fool members of the German High Command, including the Kaiser himself.;
Algol  Tragdie der Macht| An alien from the planet Algol gives a man a device that gives him superpowers.;
Anna Bolena| The story of the illfated second wife of the English king Henry VIII, whose marriage to the Henry led to momentous political and religious turmoil in England.;
April Folly| April Folly is a 1920 American silent drama film directed by Robert Z. Leonard and written by Adrian Johnson and Cynthia Stockley. The film stars Marion Davies, Madeline Marshall, Hattie ...;
Latlantide| Two men, lost in the desert, meet Queen Antinea, ruler of Atlantis.;
Pagine dal libro di Satana| In 4 episodic tales of human suffering the temptation of Jesus, the Spanish Inquisition, the French Revolution and the RussoFinnish war of 1918, Satan attempts to win Gods favor.;
Dr. Jekyll e Mr. Hyde| Dr. Henry Jekyll experiments with scientific means of revealing the hidden, dark side of man and releases a murderer from within himself.;
Erotikon| EROTIKON surely pushed the boundaries of what was acceptable on the screen in 1920 Irene, the bored wife of a distracted entomologist, pursues a womanizing aviator, but she may actually be...;
FanteAnne| The story of an orphaned girl brought up by the Storlein family. Young Anne Asta Nielsen is brought as an infant to the Storlein farm by her mother, who has been traveling and is in need ...;
The Flapper| Ginger grows up in a slow town. Because of her wild attitude, her father decides to send her to a strict boarding school. Despite the strictness, the girls have fun getting into flapper lifestyle trouble including flirting.;
Il cammino nella notte| Dr Eigil Borne is engaged to Hlne, a girl who is madly in love with him. At Hlnes birthday celebration, Eigil invites her to a cabaret, where he meets his other love, Lily, a passionate, fiery and funny dancer.;
Genuine| Extremely rare work of Robert Wiene. From the director and year of excellent The Cabinet of Dr. Caligari this work was eventually overshadowed by the success of Caligari. It has a dreamy atmosphere, like another world or something.;
Il Golem  Come venne al mondo| In 16thcentury Prague, a rabbi creates the Golem  a giant creature made of clay. Using sorcery, he brings the creature to life in order to protect the Jews of Prague from persecution.;
Headin Home| The true story of baseball great Babe Ruth Ruth plays himself.;
LHirondelle et la Msange| A bargeman, his wife and sisterinlaw navigate the canals of northern Belgium in their two vessels, the eponymous LHirondelle et la Msange, taking the time to appreciate the sites and ...;
La giustizia del mare| Nolff, a tough Breton fisherman is happy his wife has just given birth to a son, Michel. His only wish is to make him a fisherman like him. But when he becomes a man, Michel becomes a ...;
Humoresque| Young Leon Kanter dreams of being a great violinist. His parents scrape up the money for a violin and for lessons, and Leon rewards them by becoming a great player. But as an adult, Leon ...;
Luomo dal coltello a serramanico| A lonely old riverboat man is left a child by a dying mother. The old man and the boy grow to love one another. The village snoop feels the child would be better off in an orphanage and the...;
Just Pals| Smalltown tramp befriends runaway boy.;
Der Klosterjger| A hunter provides meat for a monastery in the mountains and finds romance as well.;
Klostret i Sendomir| Two weary travelers come upon a monastery. While staying the night, they learn of its mysterious founding.;
Due sorelle| Somewhere in Southern Bavaria Xaver wants to marry Gretel, but her father Kohlhiesel wants his elder daughter Liesel to marry first. The problem is, nobody wants to marry her, because shes...;
The Last of the Mohicans| As Alice and Cora Munro attempt to find their father, a British officer in the French and Indian War, they are set upon by French soldiers and their cohorts, Huron tribesmen led by the evil...;
The Love Expert| A selfappointed love expert tries to play cupid with uneven results.;
The Love Flower| A man murders his wifes lovers, escapes with his daughter to the South Pacific. A detective pursues him, joined by a young man who eventually falls in love with the daughter.;
Il segno di Zorro| A seemingly idiotic fop is really the courageous vigilante Zorro, who seeks to protect the oppressed.;
Markens grde| After the Nobel prize winning Knut Hamsunnovel, with its criticism of industrialization, urbanizing and loss of values. The farmer Isak makes a farm out of barren soil, together with Inger and their two sons. She kills the third.;
Un pulcino nella stoppa| An American who has lived much of his life outside the country returns to Arizona for the first time in years and encounters villainy.;
Nomads of the North| A Canadian Mountie allows an innocent fugitive to escape with the women he loves.;
Pollyanna| An orphans optimistic outlook brings a change to the illtempered town in which she resides to her aunt.;
La vedova del pastore| A young man is elected by a small village to be its parson. As part of his duties, he is required to marry the widow of the parson before him. This poses two problemsfirst, the widow is ...;
The Restless Sex| A young woman is torn between two men, her childhood sweetheart and a handsome art student.;
Romeo e giulietta sulla neve| Comical variation on the Shakespeare play, featuring two feuding farmers families.;
The RoundUp| An overweight sheriff does his best to assist a man accused of theft.;
The Saphead| The simpleminded son of a rich financier must find his own way in the world.;
Sex| A broadway actress uses her sex appeal to ruin a marriage only to dump her lover for a richer prospect.;
Something to Think About| Wealthy cripple Markley finances the education of blacksmiths daughter Ruth. When she returns to their small town he asks to marry her, but she runs off with city worker Jim Dirk who is ...;
Die Spinnen, 2. Teil  Das Brillantenschiff| Kay Hoog wants to stop the organisation Die Spinnen to get a certain diamond, that will give the owning woman the crown of Asia, but the man, who should be the owner of that diamond, ...;
Suds| A London laundress attempts to rise above her station in order to capture the love of a wealthy young man, thus missing out on the truer love of one of her own class.;
Sumurum| The favorite slave girl of a tyrannical sheik falls in love with a cloth merchant. Meanwhile, a hunchback clown suffers unrequited love for a traveling dancer who wants to join the harem.;
Terror Island| An inventor travels to the South Seas, where there is buried treasure belonging to a girl. The girls father is being held captive by cannibals until she returns a pearl that belongs to one of their idols.;
The Toll Gate| After being betrayed to the law by one of his henchmen, a bandit leader seeks to avenge himself.;
Von morgens bis mitternachts| A Cashier in a bank in a small German town is alerted to the power of money by the visit of a rich Italian lady. He embezzles 60, 000 Marks and leaves for the capital city, where he ...;
Das wandernde Bild| Mia May has surrendered herself to a disciple of free love, and, having given birth to a child, marries the twin brother and Doppelgnger of her chosen lover.;
Agonia sui ghiacci| A naive country girl is tricked into a sham marriage by a wealthy womanizer, then must rebuild her life despite the taint of having borne a child out of wedlock.;
Why Change Your Wife| Robert and Beth Gordon are married but share little. He runs into Sally at a cabaret and the Gordons are soon divorced. Just as he gets bored with Sallys superficiality, Beth strives to ...;
Within Our Gates| Abandoned by her fianc, an educated black woman with a shocking past dedicates herself to helping a near bankrupt school for impoverished black youths.;
The Ace of Hearts| A romantic rivalry among members of a secret society becomes even tenser when one of the men is assigned to carry out an assassination.;
Adventures of Tarzan| Tarzan spurns the love of La, Queen of Opar. When he isnt trying to keep the Bolshevik Rokoff and Clayton pretender to the Greystoke estate from reaching Opar, he is attacked ...;
Fragilit, sei femmina| Socialite Anatol Spencer seeks a better relation that he has with his wife. He sets up the friend of his youth Emilie in an apartment only to have her twotime him. He comforts the near ...;
Be My Wife| Max is determined to woo Mary, despite her Aunt Agathas disapproval.;
Lo scoiattolo| A charismatic lieutenant newly assigned to a remote fort is captured by a group of mountain bandits, thus setting in motion a madcap farce that is Lubitsch at his most unrestrained.;
The Blot| The Professor dispenses the wisdom of the ages and does not make a living wage. The sons of the rich and powerful are students lacking any motivation. The next door neighbor of the ...;
Buried Treasure| Strung around the idea of reincarnation, this film goes back in time to the days of the Spanish galleons and pirates burying their treasure treasure to be found centuries later.;
Camille| A courtesan and an idealistic young man fall in love, only for her to give up the relationship at his statusconscious fathers request.;
La commedia umana| After losing his father, a playboy moves in with his miserly uncle, who seeks to cheat him out of his inheritance.;
Dream Street| Three men in London compete for the love of a dancehall girl.;
Ducks and Drakes| Heiress Teddy Simpson avoids boredom by calling random men to flirt despite having a fiance, Rob Winslow. Trouble arises when she meets a few of them and they expect to marry her. She must ...;
Eldorado| Sibilla is a single mother, working as a gypsy dancer in a lousy cafe in the south of Spain. Unable to keep with the costs of his sons medical bills, she asks for help to Estiria, her ...;
Enchantment| The frothy experiences of a vain little flapper. Her father induces an actor friend to become a gentlemanly cave man and the film becomes another variation of the Taming of the Shrew ...;
Forbidden Fruit| Mary Maddock becomes a seamstress after her husband Steve wastes their money on booze. Her employer provides her as an escort to accompany millionaire Mallory. Her husband tries ...;
I quattro cavalieri dellApocalisse| An extended family split up in France and Germany find themselves on opposing sides of the battlefield during World War I.;
Amleto| Danish silent moviestar Asta Nielsen formed her own production company to make this film, in which new elements are combined with features and a few lines familiar from Shakespeares ...;
Hintertreppe| A crippled mailman is in love with a maid who lives in the same building he does in one of the citys poor neighborhoods. She, however, is in love with a wealthy, handsome young man. ...;
Das indische Grabmal zweiter Teil  Der Tiger von Eschnapur| Howard is infected with leprosy, Mac Allen was captured by the Maharadsha, and now the Maharadsha offers Irene a deal one night for letting healing Howard. She accepts, but when she tries ...;
Das indische Grabmal erster Teil  Die Sendung des Yoghi| First part of a serial spectacle, in which the unfaithful wife of a cruel Indian prince attempts to escape from his domination.;
Johan| On a farm in upcountry Sweden, an enigmatic stranger comes to a conservative peasant community and seduces a farmers wife.;
Il monello| The Tramp cares for an abandoned child, but events put that relationship in jeopardy.;
Il carrettiere della morte| On New Years Eve, the driver of a ghostly carriage forces a drunken man to reflect on his selfish, wasted life.;
Leap Year| A young man, heir to his misogynistic and millionaire uncle, and in love with a nurse, gets in trouble when he gives advice on marriage to his girlfriends.;
Little Lord Fauntleroy| An American boy turns out to be the longlost heir of a British fortune. He is sent to live with the cold and unsentimental lord who oversees the trust.;
The Love Light| Angela maintains a coastal lighthouse in Italy, where she awaits the return of her brothers from the war. She learns they are casualties and takes solace in the arms of an American sailor ...;
Miss Lulu Bett| A oncetimid young woman gains newfound confidence after a failed marriage, much to the chagrin of her miserable family.;
My Boy| An orphan escapes immigration officials at Ellis Island and goes to live with an old ships master who cant find work and cant pay the rent.;
Destino| When a womans fianc disappears, Death gives her three chances to save him from his fate.;
The Nut| Eccentric inventor Charlie Jackson tries to interest wealthy investors in his girlfriends plan to help children from poor neighborhoods.;
Le due orfanelle| Two orphaned sisters are caught up in the turmoil of the French Revolution, encountering misery and love along the way.;
Outside the Law| In this early collaboration with director Tod Browning Dracula, Freaks, Chaney delivers a dual performance of dramatic intensity, starring as Ah Wing, a kindhearted student of Confucian ...;
Roj no reikion|  NA;
A SailorMade Man| An idle, wealthy playboy foolishly joins the Navy when the father of the girl he wants to marry tells him to get a job to prove himself worthy.;
Sappho| Richard De La Croix has a brother, Andreas, who has been driven insane by a notorious vamp and socialite named Sappho. A manabouttown named Teddy takes Richard to the Odeon to meet her, ...;
Scherben| Set during the winter, the story tells the tale of a track checker and his family who live a povertystricken life next to a railway line. They receive a telegram announcing the arrival of ...;
Il castello di Vogelod| In the castle Vogeloed, a few aristocrats are awaiting baroness Saffersttt. But first count Oetsch invites himself.. Everyone thinks he murdered his brother, baroness Safferstats first ...;
Lo sceicco| A charming Arabian sheik becomes infatuated with an adventurous, modernthinking Englishwoman and abducts her to his home in the Saharan desert.;
The Sky Pilot| The sky pilot is a preacher who helps Gwen walk again after a nearfatal accident.;
La terre| As Jean is walking across the countryside in search of work, he helps and befriends a young woman, Franoise, who is having trouble controlling the cow that she is leading. Jean finds work ...;
The Three Musketeers| The young Gascon DArtagnan arrives in Paris, his heart set on joining the kings Musketeers. He is taken under the wings of three of the most respected and feared Musketeers, Porthos, ...;
Through the Back Door| When her mother remarries, a young Belgian girl is left behind with her nurse, but when Germany invades the country, she is sent to America to find her mother.;
La pazienza di Davide| When three thuggish men are responsible for the death of his father and the crippling of his brother, young David must choose between supporting his family or risking his life and exacting vengeance.;
Too Wise Wives| An insecure wife fears her husband may be straying back to an old flame.;
Vier um die Frau| Harry Yquem, a wealthy broker, remains obsessed with delusions of his devout wifes infidelity.;
Beautys Worth| Prudence Cole is an unsophisticated Quaker girl being raised by her two aunts. Prudence is flirted with by snobbish Henry Garrison, who actually disdains the girl for her lack of ...;
Let di amare| A young woman marries an older millionaire and then falls in love with a handsome nobleman on her honeymoon.;
Sangue e arena| A toreadors familial and social life is threatened when he has an affair.;
La terra che brucia| When farmer Rog dies, his son Peter stays, but Johannes can not be satisfied with such a condition and servant Marias love and finds a job as old Count Rudenbergs secretary. His ...;
The Brides Play| An Irish lass is torn between the poet who seduced her and noble man who truly loves.;
Crainquebille| A poor vegetable peddler in Paris runs afoul of the law and finds himself ground up in the cogs of the corrupt French judicial system.;
Der var engang| A beautiful but imperious princess refuses all offers of marriage, often condemning her suitors to death. The prince of Denmark comes seeking her hand and, aided by magic objects given to him by a mysterious spirit, seeks to win her love.;
Dr. Jack| Country Doctor, Jack Jackson is called in to treat the SickLittleWellGirl, who has been making Dr. Saulsbourg and is sanitarium very rich, after years of unsuccessful treatment. His ...;
Down to the Sea in Ships| Story of the lives of the people in a small Quaker community and the adventures of a whaling ship.;
La femme de nulle part| A woman appears at the house where she used to live a long time ago. The new inhabitants, a married couple with a toddler, welcome her to stay for the night. Meanwhile, the wife has to choose between family and adventure.;
Flesh and Blood| A convict hiding in Chinatown assumes the identity of a cripple to track down a businessman who framed him 15 years previously. He discovers that his daughter has fallen in love with the businessmans son.;
Femmine folli| A con artist masquerades a Russian nobility and attempts to seduce the wife of an American diplomat.;
Gli stigmatizzati| Based on the 1918 novel Elsker hverandre by Aage Madelung, the film follows various lives, one of which is Jewish girl Hanne Liebe, as she grows up, and experiences the pains of living as a Jew in Russia, leading to a revolution.;
Il talismano della nonna| A meek young man must find the courage within when a rogue tramp menaces his home town.;
The Headless Horseman| The village of Sleepy Hollow is getting ready to greet the new schoolteacher, Ichabod Crane, who is coming from New York. Crane has already heard of the villages legendary ghost, a ...;
Lorna Doone| In 17thcentury England, an outlaw clan kidnaps a young girl, who grows up among them. The farm boy who met her just before the kidnapping eventually rescues her, and they fall in love.;
The Man from Beyond| A man who has been frozen in the Arctic ice for 100 years returns to civilization to find his lost love.;
Manslaughter| Societygirl thrill seeker Lydia causes the death of motorcycle policeman and is prosecuted by her fianc Daniel who describes in lurid detail the downfall of Rome. While shes in prison she reforms and Daniel becomes a wasted alcoholic.;
Donne viennesi| A nobleman, posing as a necktie salesman, falls in love with the daughter of a circus puppeteer, even though he is already married to the daughter of his countrys war minister.;
Monte Cristo| A film adaptation of the classic Alexandre Dumas novel. Edmond Dantes is falsely accused by those jealous of his good fortune, and is sentenced to spend the rest of his life in the ...;
Moran of the Lady Letty| A milquetoast young man of society toughens up once hes shanghaied and falls for the captains tomboy daughter.;
Nathan il saggio| One of the main works of the Age of Enlightenment, a powerful plea in favour of tolerance, humanity and freedom of opinion. Set in the age of the crusades, it deals with the relations ...;
Nosferatu  Il vampiro| Vampire Count Orlok expresses interest in a new residence and real estate agent Hutters wife.;
Oliver Twist| An orphan named Oliver Twist meets a pickpocket on the streets of London. From there, he joins a household of boys who are trained to steal for their master.;
Othello| Based on Shakespeares play The treacherous Iago plans to ruin the life of Othello by provoking him to jealousy.;
Fantasma| A shiftless young man becomes obsessed with a mysterious woman and yearns to find her again.;
The Prisoner of Zenda| When the king is drugged and abducted by his ambitious brother, a lookalike relative must take his place to keep the evil sibling off the throne.;
Robin Hood| A nobleman becomes the vigilante Robin Hood who protects the oppressed English people from the tyrannical Prince John.;
Salom| Salome, the daughter of Herodias, seduces her stepfatheruncle Herod, governor of Judea, with a salacious dance. In return, he promises her the head of the prophet John the Baptist.;
Saturday Night| Though betrothed to fellow socialite Richard, Iris weds her chauffeur Tom leaving Richard to marry the family laundress daughter Shamrock. Class differences lead to divorces and remarriages.;
Ombre ammonitrici| A wealthy man invites the local wealthy bachelors over for a puppet show about men who covet another mans wife. The puppeteer is actually a witch and gives the men nightmares about what could happen if they date the lady of the house.;
The Seventh Day| A group of New York society folk on a yachting excursion are forced to put into a New England fishing village for repairs. The engaged couple Reggie and Patricia are taken with the quaint ...;
Shadows| A dying Chinese man converts to Christianity in order to stop a friend from being blackmailed.;
Sherlock Holmes| A young Sherlock Holmes seeks to bring down the criminal mastermind Moriarty as he solves a crime involving a blackmailed prince.;
Sky High| A government agent investigates a ring that is smuggling Chinese aliens across the border from Mexico. His investigation takes him to the Grand Canyon. He finds a dazed girl wandering ...;
Sodom und Gomorrha| When the old multimillionaire Jackson Harber wants to marry the young model Mary, she hesitates, but her mother convinces her that this is her chance to lead a life in luxury and leisure. ...;
Tess of the Storm Country| Wealthy Elias Graves builds his home on the top of a hill, where a group of squatters have taken up residence at the bottom. Many of the men in the squatters village have their eyes on ...;
The Three MustGetTheres| This delightful burlesque of Alexandre Dumas famous adventure narrative and thenleading screen swashbuckler Douglas Fairbanks hit films represented one of writerdirectorstar Max ...;
The Toll of the Sea| While visiting China, an American man falls in love with a young Chinese woman, but he then has second thoughts about the relationship.;
The Trap| A miners happiness is destroyed when a rival steals his mine. He becomes obsessed with revenge, and plans a trap for the man who took his mine.;
Trapped by the Mormons| Mormons capture women for their wives in this silent antiMormon propaganda film featuring the original organ music.;
Das Weib des Pharao| The Ethiopian King offers his daughter to a powerful Pharaoh to secure peace between the two countries.;
When Knighthood Was in Flower| Mary Tudor, sister of Englands Henry VIII, causes a stir by falling in love with a guardsman below her class.;
The Young Rajah| A young man raised in the American South discovers he is an Indian prince whose throne was taken by usurpers.;
Das alte Gesetz| Baruch Mayr, son of an orthodox rabbi from a poor shtetl in Galizia, decides to break with the family tradition and leave the shtetl to become an actor. Due to this behaviour his father ...;
Ladro damore| Wrongfully blamed for the death of Col. John Randall, Cameo Kirby Gilbert must find the true villain and clear his name before he can declare his love for Adele Olmstead, the dead mans...;
Cuore fedele| Marie wants to escape from her job and also from her lover, Paul, an unemployed drunk. She dreams of going off with Jean, a dockworker. The two men quarrel and fight over Marie on two ...;
I pionieri| Two wagon caravans converge at what is now Kansas City, and combine for the westward push to Oregon. On their quest the pilgrims will experience desert heat, mountain snow, hunger, and ...;
The Extra Girl| Sue Graham is a small town girl who wants to be a motion picture star. She wins a contract when a picture of a very pretty girl is sent to a studio instead of her picture. When she arrives ...;
Il vecchio castello| Gunnar Hede, a young Swedish man, wants to become a professional musician, but when his father suddenly dies he is pressured by his family to take over the family business, raising and ...;
La leggenda di Gosta Berlings| A drunkard priest who has been cast out by his community struggles to atone and regain his honour and dignity.;
Haldane of the Secret Service| Heath Haldane Houdini tracks down a vicious gang of counterfeiters, narrowly missing death several times. He must rescue Adele Ormsby, whom he loves despite her pending marriage.;
Il gobbo di Notre Dame| In 15thcentury Paris, the brother of the archdeacon plots with the gypsy king to foment a peasant revolt. Meanwhile, a freakish hunchback falls in love with the gypsy queen.;
Little Old New York| An Irish girl comes to America disguised as a boy to claim a fortune left to her brother who has died.;
Accidenti che ospitalit| A man returns to his Appalachian homestead. On the trip, he falls for a young woman. The only problem is her family has vowed to kill every member of his family.;
Il pellegrino| The Tramp is an escaped convict who is mistaken as a pastor in a small town church.;
Raskolnikow| Student Raskolnikow, who has written an article about laws and crime, proposing the thesis, that unordinary people can commit crimes if their actions are necessary for the benifit of ...;
Rosita| Rosita, a peasant singer in Seville, captures the attention of the King.;
La rosa sulle rotaie| Sisif, a railwayman, and his son Elie fall in love with the beautiful Norma who Sisif rescued from a train crash when a baby and raised as his daughter, with tragic results. Originally ...;
Preferisco lascensore| A boy leaves his small country town and heads to the big city to get a job. As soon as he makes it big his sweetheart will join him and marry him. His enthusiasm to get ahead leads to some interesting adventures.;
Scaramouche| When a nobleman murders his best friend, a lawyer becomes a revolutionary with his heart set on vengeance.;
Il tesoro| In and around a bell maker near Marburg today Slovenia people tell the story of a treasure that was hidden during the Turki invasion of 1683, the year the Turkish Army was besieging ...;
The Shock| A gang of blackmailers sends a cripple to San Francisco to expose a banker they have been blackmailing. However, the cripple meets and falls in love with the bankers daughter.;
Souls for Sale| A young woman hits Hollywood, determined to become a star.;
Die Strae| Presents two distinct plot lines until the two eventually merge the first is that of the bored middleaged man seeking a departure from monotony in his life the second is that of the ...;
La notte di San Silvestro| The film is set in a bar on New Years Eve. We see plenty of Germans swilling beer nonstop and the owner of the bar and his wife await the arrival of his mother for a little celebration together.;
I dieci comandamenti| After hearing the story of Moses, the sons of a devout Christian mother go their own ways, while the atheist brothers breaking of the Ten Commandments leads to tragedy.;
Senti, amore mio| The misadventures of Buster in three separate historical periods.;
Das Wachsfigurenkabinett| A wax museum hires a writer to give the sculptures stories. The writer imagines himself and the museum owners daughter in the stories.;
The White Rose| A wealthy young Southern aristocrat, Joseph, graduates from a seminary and, before he takes charge of his assigned parish, decides to go out and see what the real world is all about. He ...;
La suora bianca| A young woman becomes a nun when she believes her sweetheart has been killed, but things get complicated when he returns alive.;
White Tiger| Three crooks pull off a magnificent crime. As theyre forced to hide out together they slowly begin to distrust each other.;
Perch preoccuparsi| A hypochondriac vacations in the tropics for the fresh air  and finds himself in the middle of a revolution instead.;
La donna di Parigi| A kept woman runs into her former fianc and finds herself torn between love and comfort.;
Zaza| Zaza is an actress and the favorite at an openair theater in a small French town. When diplomat Bernard Dufresne comes to the village, he stays away for fear he will fall for her. But when Zaza is badly injured, he has no choice.;
Aelita| A mysterious radio message is beamed around the world, and among the engineers who receive it are Los, the hero, and his colleague Spiridonov. Los is an individualist dreamer. Aelita is the...;
America| The story of a family caught up in the American Revolutionary War.;
Beau Brummel| George Bryan Brummel, a British military officer, loves Lady Margery, the betrothed of Lord Alvanley. Despite her own desperate love for Brummel, she submits to family pressure and marries ...;
Black Oxen| A Manhattan playboy falls in love with a mysterious European woman, whom he notices as an exact double for a famous socialite who disappeared at the turn of the century. At first, he thinks...;
Captain January| A lighthouse keeper finds a little girl who is washed ashore tied to some wreckage. He adopts her and they become inseparable. Eventually her real family finds her and tries to take her away.;
The Chechahcos| A fire engulfs a shipload of prospectors and adventurers making their way to Alaska. In the confusion, Mrs. Stanlaw is separated from her young daughter, who ends up in the care of ...;
Dantes Inferno| The tactics of a vicious slumlord and greedy businessman finally drive a distraught man to commit suicide. The businessman is tried for murder and executed, and is afterward taken by demons...;
Dorothy Vernon of Haddon Hall| In the year 1550, Sir George Vernon agrees to have his young daughter Dorothy betrothed to John Manners, the son of the Earl of Rutland. Sir George signs a contract, promising that the ...;
The Enchanted Cottage| A crippled World War I veteran retracts to a small cottage in the countryside to escape from his nosy family and to hide from the outside world. There he meets a plain but also a very kind ...;
The Family Secret| A modest man unknowingly has a baby with a woman from a affluent family.Through a series of coincidences he is reunited with his daughter, forcing the family to confront its secrets.;
La fille de leau| After her fathers death and her uncle having drunk all the inheritance, Virginia is left alone. She is accepted by a family of bohemians but a quarrel between the bohemians and the ...;
Finanze del granduca| The likeable and carefree Grand Duke of Abacco is in dire straits. There is no money left to service the States debt the main creditor is looking forward to expropriating the entire Duchy...;
La zarina| Alexei saves the Czarina from conspirators and is rewarded with her love. He deserts his sweetheart Anna, but discovers that his Queen is unfaithful too. Enraged, Alexei becomes a leader in the ongoing revolution against the royals.;
Tutte e nessuna| A shy, young man, who is completely incapable of talking to women, decides to write a book that details to other bachelors how to find a girlfriend.;
Quello che prende gli schiaffi| A bitter clown endeavors to rescue the young woman he loves from the lecherous count who once betrayed him.;
Her Night of Romance| An impoverished British lord Paul Menford impersonates a doctor in order to woo an ailing American heiress Dorothy Adams. The lord is in it for love, but his business associate Joe Diamond smells money.;
Il re degli scapoli| Episodic look at married life and inlaw problems. Adventures include a ride on a crowded trolley with a live turkey a wild spin in a new auto with the inlaws in tow and a sequence in ...;
Futurismo| Claire Lescot is a famous first lady. All men want to be loved by her and among them is the young scientist Einar Norsen. When she mocks at him, he leaves her house with the declared intention to kill himself.;
Il cavallo dacciaio| After witnessing the murder of his father by a renegade as a boy, the grownup Brandon helps to realize his fathers dream of a transcontinental railway.;
Isnt Life Wonderful| A family of Polish refugees tries to survive in postWorld War I Germany. For a while it seems that they are making it, but soon the economic and political deterioration in the country begins to take their toll.;
Janice Meredith| It is 1774, the eve of the American War of Independence. Janice comes from a Tory household. She cavorts with American and British alike, is pursued by Charles Fownes, patriot and friend of...;
Kean| When a famous Shakespearean actor falls in love with a woman above his station, his professional and personal life begin to crumble.;
Lultima risata| An aging doorman, after being fired from his prestigious job at a luxurious Hotel is forced to face the scorn of his friends, neighbours and society.;
Manhandled| Gloria Swanson plays Tessie McGuire, a shopgirl who, when her boyfriend breaks their date one evening, goes to a party with a louche crowd of artists and hangerson. She wows them with some...;
Matrimonio in quattro| Professor Stock and his wife Mizzi are always bickering. Mizzi tries to seduce Dr. Franz Braun, the new husband of her good friend Charlotte. Dr. Brauns colleague, Dr. Mueller, who has had...;
Michael| Triangle story painter, his young male model, unscrupulous princess.;
Monsieur Beaucaire| When M. Beaucaire, a handsome barber, catches the Duke of Winterset cheating at gambling, Beaucaire exacts Wintersets cooperation in sneaking Beaucaire into a great ball, disguised as the ...;
Il navigatore| Two spoiled rich people find themselves trapped on an empty passenger ship.;
Le straordinarie avventure di mr. West nel paese dei bolscevichi| Experience the chronicle adventures of Mr. West and his faithful bodyguard and servant Jeddie, as they visit the land of the horrible and evil Bolsheviks.;
I Nibelunghi La vendetta di Crimilde| After Siegfrieds dead, Kriemhild marries Etzel, the King of the Huns. She gives birth to a child, and invites her brothers for a party. She tries to persuade Etzel and the other Huns, that...;
I Nibelunghi Sigfrido| Siegfried, son of King Sigmund, hears of the beautiful sister of Gunter, King of Worms, Kriemhild. On his way to Worms, he kills a dragon and finds a treasure, the Hort. He helps Gunther to...;
Open All Night| A couples marriage is going stale. She wants a takecharge kind of guy, someone wholl show her who the boss is. Hes not that type, and in fact believes that women dont really respect ...;
Orlacs Hnde| A worldfamous pianist loses both hands in an accident. When new hands are grafted on, he doesnt know they once belonged to a murderer.;
Papirosnitsa ot Mosselproma| As she works in her tedious office job, Maria Ivanovna dreams about being married, and she has particular hopes that her coworker Nikodim Mityushin will take an interest in her. Nikodim, ...;
Paris qui dort| A scientists invisible ray freezes Paris into immobility.;
Peter Pan| Peter Pan enters the nursery of the Darling children and, with the help of fairy dust, leads them off to Never Never Land, where they meet the nefarious Captain Hook.;
The Red Lily| Two young lovers escape their past lives to Paris until fate separates them.;
Romola| In Renaissance Florence, Tito, a nogood young man pretending to be a scholar, wins the admiration of a blind man who has long looked for someone to finish his scholarly work. He has a ...;
The Sea Hawk| A wrongly convicted English gentleman goes from galley slave to pirate captain.;
Secrets| After 40 years of struggle on the Wyoming frontier, a woman reflects on her hardscrabble life with her unfaithful husband.;
La palla n 13| A film projectionist longs to be a detective, and puts his meagre skills to work when he is framed by a rival for stealing his girlfriends fathers pocketwatch.;
Sciopero| A group of oppressed factory workers go on strike in prerevolutionary Russia.;
Il ladro di Bagdad| A recalcitrant thief vies with a duplicitous Mongol ruler for the hand of a beautiful princess.;
Lombra bianca| In Paris a wild girl becomes possessed by the soul of her twin who died to save her life.;
Arance selvatiche| Millie Stope lives with her grandfather on a remote island. Her grandfather fled there for political reasons. But theyre not alone. An escaped prisoner, Nicholas, is terrorizing them, and ...;
Il vino della giovinezza| Unlike earlier generations of Marys who used every trickery to secure husbands, Mary the Third questions the validity of marriage in her search for adventure. Unable to decide between quiet...;
Yolanda| Princess Mary of Burgundy, traveling in disguise using the name of Yolanda, attends a silk fair and falls in love with Maximilian, who has disguised himself as a knight. Later Maximilian is...;
Le avventure del principe Achmed| A handsome prince rides a flying horse to faraway lands and embarks on magical adventures, which include befriending a witch, meeting Aladdin, battling demons and falling in love with a princess.;
La grande parata| A young American soldier witnesses the horrors of the Great War.;
Body and Soul| A minister is malevolent and sinister behind his righteous facade. He consorts with, and later extorts from, the owner of a gambling house, and betrays an honest girl, eventually driving ...;
Braveheart| Chief Standing Rocks tribe has a treaty protecting their fishing grounds, but a canning corporation is violating the treaty through intimidation and force. The tribe is divided as to how ...;
La corazzata Potemkin| In the midst of the Russian Revolution of 1905, the crew of the battleship Potemkin mutiny against the brutal, tyrannical regime of the vessels officers. The resulting street demonstration in Odessa brings on a police massacre.;
The Circle| Elizabeth Cheney has a wealthy husband, social prominence and everything she could want in life . . . except Ted Lutton, the man she loves. Now, she must decide whether to give up ...;
Clash of the Wolves| A fire in the mountains drive a wolf pack into a nearby desert where they will terrorize the local residents.;
Cobra| A penniless, skirtchasing Italian nobleman finds love and scandal when he travels to New York City.;
Don Q Son of Zorro| Don Cesar, son of Zorro, is framed for murder while visiting Spain, and becomes the whipwielding outlaw Don Q.;
Langelo del focolare| When a man becomes tyrannical towards his family, the women of the house decide to teach him a lesson in gratitude.;
Aquila nera| A wanted Russian lieutenant becomes a masked vigilante seeking vengeance upon the man who stole his familys land, only to fall for his charming daughter.;
Il fantasma del Moulin Rouge| A man goes to the lonely estate of the mysterious Dr. Renault, whose strange experiments release the mans spirit from his body.;
Il fu Mattia Pascal| Mathias Pascal, only son of a once rich family, marries beautiful Romilde, who has a terrible motherinlaw. She controls her daughter, and soon his home life becomes a nightmare, as well ...;
Viva lo sport| A nerdy college student will do anything to become popular on campus.;
La via senza gioia| Vienna in the biggest depression, directly after WW1. In a slum, Lila Leid, the wife of lawyer Leid is murdered, Egon, secretary of one of Leids clients is arrested. He was with her, and ...;
Furusato no uta| As all his peers leave the countryside to study in Tokyo, Naotaro stays behind.;
La fidanzata di Glomdal| Tore takes over the rundown family farm. Applying his youthful energy, he intends to make it into a big farm like Glomgrden on the other side of the river, where beautiful Berit lives. ...;
Io e la vacca| With little luck at keeping a job in the city a New Yorker tries work in the country and eventually finds his way leading a herd of cattle to the West Coast.;
La febbre delloro| A prospector goes to the Klondike in search of gold and finds it and more.;
The Goose Woman| A famous opera singer lost her voice when her son was born, and has drowned her sorrows in drink. When a murder is committed near her house, she invents a story in order to get herself back...;
Rapacit| The sudden fortune won from a lottery fans such destructive greed that it ruins the lives of the three people involved.;
Gribiche| A sincere workingclass 13year old in France is adopted by a wellmeaning philanthropic millionairess from America  who promises his doting mother that the boy will have the finest education  but things are not so simple.;
Her Sister from Paris| A housewife poses as her sister, a notorious dancer, in order to fool her husband and teach him a lesson.;
El hsar de la muerte| The story of Manuel Rodriguez;
Il ventaglio di Lady Windermere| A society woman believes her husband is having an affair, a misconception which may have dire personal consequences for all involved.;
Lady of the Night| A worldweary prostitute yearns after respectability and the love of an inventor.;
The Lady| A young woman marries the wastrel son of a British aristocrat. Her husband, who has been disinherited by his father, loses what little money he has left gambling in casinos and then dies, ...;
Lazybones| Steve Tuttle, the titular lazybones, takes on the responsibility of raising a fatherless girl, causing a scandal in his small town. Many years later, having returned from World War I, he ...;
Lights of Old Broadway| Lights of Old Broadway 1925 is a drama film directed by Monta Bell, produced by William Randolph Hearsts Cosmopolitan Productions, and released by MetroGoldwynMayer. The film stars ...;
Little Annie Rooney| The tenements are home to an international community, including the friends and family of a tough young ragamuffin named Annie Rooney, but their neighborhood may be threatened by a dangerous street gang.;
Il piccolo colonnello| After Southern belle Elizabeth Lloyd runs off to marry Yankee Jack Sherman, her father, a former Confederate colonel during the Civil War, vows to never speak to her again. Several years ...;
Un mondo perduto| The first film adaptation of Sir Arthur Conan Doyles classic novel about a land where prehistoric creatures still roam.;
La vedova allegra| A prince must woo the now wealthy dancer he once abandoned in order to keep her money in the country in order to keep it from crashing economically.;
The Monster| A meek clerk who doubles as an amateur detective investigates some very strange goingson at a remote mental sanitarium.;
The Mystic| An American criminal imports a gang of Hungarian gypsies to gain control over a fortune. The victim, Doris Merrick, is persuaded by fake medium Zara to hand over her jewels to Nash.;
Orochi| The story of a decent samurai who is widely considered a scum and a criminal. His bad luck and numerous misunderstandings drag him down the social ladder straight to the gutter.;
Parisian Love| Street people Armand and Marie are madly in love, and she persuades Armand and other gang members to rob the home of Pierre Marcel, a wealthy scientist. The police break up the robbery but ...;
Paths to Paradise| A conwoman has a nice business going in fleecing gullible tourists who want a genuine underworld experience  but the tables are turned when one of her victims turns out to be less ...;
Il fantasma dellopera| A mad, disfigured composer seeks love with a lovely young opera singer.;
The Plastic Age| Hugh Carver is an athletic star and a freshman at Prescott College. He falls in love with Cynthia Day, a popular girl who loves to go to parties. He finds that it is impossible to please ...;
Il labirinto delle passioni| Two couples romances are fancifully intertwined.;
Poil de carotte| Franois mother, Mme Lepic, hates him and she nicknames him Poil de Carotte Carrot hair. His father is more interested in politics and hunting that he is in him. In spite of the ...;
Prem Sanyas| This adaptation of Arnolds 1861 Orientalist epic opens with documentary shots of tourists in Bombay watching street performers. Then a whitebearded old man sitting under the bodhi tree ...;
Pretty Ladies| Maggie, a headlining comedienne with the Follies, takes a fall off the stage into the orchestra pit and lands on the drum of musician Al Cassidy. One thing leads to another, they fall in ...;
The Rag Man| Tim Kelly is an orphan who runs away after his orphanage burns down. Presumed to be killed in the fire, he is able to roam the streets of New York freely. He meets Max Ginsberg, an old ...;
The Red Kimona| A small town girl finds escape from her cruel home life in the arms of a handsome stranger. Soon she finds herself working as a prostitute in New Orleans, desperately clinging to the belief that he really loves her.;
Riders of the Purple Sage| A Texas Ranger searches for his kidnapped sister.;
The Road to Yesterday| A married couple discover their strained relationship is the result of unhappiness in their past lives.;
Zingaresca| Judge Foster throws his daughter out because she married a circus man. She leaves her baby girl with Prof. McGargle before she dies. Years later Sally is a dancer with whom Peyton, a son of...;
Sally, Irene and Mary| The three are showgirls, each with a different approach to life and love. Sally wants wealth and gets it finally in Marcus. Mary plots and schemes but winds up with saltoftheearth Jimmy....;
The Salvation Hunters| A cowardly young man, a bitter young woman and a helpless child live on the docks, spend their days full of ennui watching a dredge dig the same hole day in and day out, chased around by ...;
Le sette probabilit| A man learns he will inherit a fortune if he marries by 7 p.m. that same day.;
She| In Africa an explorer is the reincarnated lover of the 2,000yearold White Queen.;
SoulFire|  NA;
Die Stadt ohne Juden| Jews are expelled from the city of Utopia.;
Stage Struck| A young woman dreams of becoming a great actress. When her boyfriend starts to flirt with an actual actress, she becomes jealous and decides to fight with her rival.;
Stella Dallas| Stella, a small town girl, marries socialite Stephen Dallas, a man with whom she has nothing in common. The whole thing is a failure after the birth of their daughter, Laurel, the Dallases...;
Tumbleweeds| The government will grant a fringe of terrain for the settlers who want to live and work there. The starting sign will be a gunshot which will iniciate the run for the best fields and ...;
Il trio infernale| A sideshow ventriloquist, midget, and strongman form a conspiracy known as The Unholy Three and commit a series of robberies.;
The Vanishing American| History, as portrayed in this film, has been a succession of conquests of stronger races over weaker ones. As played out on the stage of Monument Valley, long ago, tribes of Indians ...;
Variet| Prologue The murderer Boss Huller  after having spent ten years in prison  breaks his silence to tell the warden his story. Boss, a former trapeze artist, and his wife own a cheap ...;
Visages denfants| A man whose wife has died remarries, and his new wife has a daughter of her own from a previous marriage. The mans young son, however, who loved his mother deeply and misses her terribly, ...;
Il viaggio immaginario| In a daydream, a shy bank clerk is led by a fairy into a subterranean world where people transform into animals and waxworks come to life. Lucie, his office crush, follows him but a bad fairy is intent on keeping them apart.;
Il mago di Oz| Dorothy, heir to the Oz throne, must take it back from the wicked Prime Minister Kruel with the help of three farmhands.;
Wolfblood| After wolf blood transfusion, man thinks hes becoming a wolf.;
A Woman of the World| A sensual European countess arrives at a small American town where she quickly provokes moral outrage from the community. Upon arriving, even before she steps out of her taxi a district ...;
Zakroyshchik iz Torzhka| An silent comedy about a provincial tailor who won a lottery in the 1925 Soviet Union.;
Zander the Great| Mamie, an orphan girl who was abused in the orphanage, is taken in by Mrs. Caldwell, a kindly woman with a young son named Alexander. Mamie hits it off with the lad, and nicknames him ...;
Lerede dei Grishus| A lord falls in love with one of his serfs and chooses to be disinherited and stripped of his title in order to marry her. Her love and gratitude extend beyond the grave.;
Bardelys il magnifico| Rafael Sabatinis story of the swashbuckling era and of Bardelys, the handsome courtier who could win any woman he set his mind to...and was not above boasting about it to all who would listen.;
The Bat| A masked criminal who dresses like a giant bat terrorizes the guests at an old house rented by a mystery writer.;
Se perdo la pazienza...| A lovestruck weakling must pretend to be boxer in order to gain respect from the family of the girl he loves.;
Beau Geste| Michael Beau Geste leaves England in disgrace and joins the infamous French Foreign Legion. He is reunited with his two brothers in North Africa, where they face greater danger from their...;
The Bells| An innkeeper murders a wealthy guest to pay off his debt, but his conscience will not allow him to get away with the crime so easily.;
The Better Ole| The adventures of Old Bill and his friends Bert and Alf in the trenches of the first World War.;
Beverly of Graustark| Beverly of Graustark 1926 is a silent film directed by Sidney Franklin, starring Marion Davies, Antonio Moreno and Creighton Hale. The films screenplay was written by Agnes Christine ...;
Il pirata nero| Seeking revenge, an athletic young man joins the pirate band responsible for his fathers death.;
Il corvo| Two thieves, the Blackbird and West End Bertie, fall in love with the same girl, a French nightclub performer named Fifi. Each man tries to outdo the other to win her heart.;
Laquila azzurra| George and Big Jim are comrades in the Navy but rivals outside it, both fighting for the love of Rose, the local policemans daughter. When the war is over Father Regan tries to unite them ...;
La Bohme| A group of starving artists try to survive in 1830s Paris, including a seamstress and the wouldbe playwright she loves.;
The Boob| Idealistic farm boy Peter loves Amy whose fancy is urbane Harry. He discovers Harry is a rum runner and turns him over to prohibition agents, including Jane. May is at last impressed with ...;
Brown of Harvard| Tom Brown shows up at Harvard, confident and a bit arrogant. He becomes a rival of Bob McAndrew, not only in football and rowing crew, but also for the affections of Mary Abbott, a ...;
Brudeferden i Hardanger| Based on the novel Marit Skjlte by Kristofer Janson, this Norwegian silent movie tells the story of young Marit and her love, Anders, who travels to America to seek his fortune. Without ...;
Dancing Mothers| Young girl becomes a flapper, defying her parents and the community.;
Don Juan| In 16th Century Italy, devilmaycare playboy Don Juan runs afoul of the despotic Borgias.;
Ella Cinders| Poor Ella Cinders is much abused by her evil stepmother and stepsisters. When she wins a local beauty contest she jumps at the chance to get out of her deadend life and go to Hollywood, ...;
Eves Leaves|  NA;
Exit Smiling| A maid who works for a traveling theatrical troupe wants desperately to be an actress, and manages to get some small roles in the companys productions, but is determined to do anything she...;
Faust| The demon Mephisto wagers with God that he can corrupt a mortal mans soul.;
Le disgrazie di adamo| In the modern day 1920s story, Adam, a plumber, is happily married to Eve, a wardrobeobsessed housewife, until she accidentally meets a supercilious fashion designer. At the prompting of...;
Fine Manners| In a run down New York Tenament, a chorine named Orchid lives with her overprotective brother Buddy, who sees to it that no uptown Casanovas get a chance at seducing his sister. At a New ...;
La carne e il diavolo| Childhood friends are torn apart when one of them marries the woman the other once fiercely loved.;
Il re degli straccioni| An irresponsible young millionaire changes his tune when he falls for the daughter of a downtown minister.;
Geheimnisse einer Seele| A scientist is tormented by an irrational fear of knives and the irresistible compulsion to murder his wife.;
The Great K  A Train Robbery| Cullen has hired Tom to try and stop the robberies on his railroad. Knowing Cullens secretary Holt is tipping off the gang, Tom works undercover by posing as a highwayman. To help him ...;
Hands Up| A southern spy during the Civil War, he must try to capture a shipment of gold. His task is complicated by the two sisters, the Indians and a firing squad.;
La montagna dellamore| Diotima meets Karl in the mountains where they fall in love and have an affair. When Karls friend, Vigo, meets her, he mistakenly believes she is in love with him. Karl then believes that she is betraying him with his friend.;
His First Flame| Fire chief Amos McCarthy, a confirmed misogynist, counsels his nephew Harry Howells to avoid matrimony at all costs. Still, the lovestruck Harry is determined to marry his sweetheart Ethel....;
Its the Old Army Game| Druggist Elmer Prettywillie is sleeping. A woman rings the night bell only to buy a twocent stamp. Then garbage collectors waken him. Next its firemen on a false alarm. And then a real fire.;
Kid Boots| A salesman is helped out of a jam with an angry customer by a wealthy playboy. In return, he agrees to help the playboy get a divorce from his wife, only to find himself falling for the ...;
Kiki| Kiki, a poor young woman who sells newspapers on the street corners of Paris, is able to land a job singing and dancing at a nearby theater. While she is there, she invites herself into the...;
Una pagina di follia| A man takes a job at an asylum with hopes of freeing his imprisoned wife.;
Il pensionante| A landlady suspects her new lodger is the madman killing women in London.;
Love Em and Leave Em| The tale of two sisters with the older one pledged to look after the younger one that transpires between a department store, NYCs Central Park and a boarding house. THe older one is the ...;
Maciste allinferno| The devil takes Maciste down to hell in an attempt to corrupt and ruin his morality.;
The Magician| A magicianalchemist, seeking to create life, finds that he needs the blood of a virgin to continue his experiments. He sends out his dwarf assistant to pick out the right girl.;
Mantrap| A sexy young manicurist living with her older backwoodsman husband in a small Canadian town finds herself attracted to a young, rich and famous divorce lawyer who comes to town on vacation.;
Mare Nostrum| The story of a female German spy who willingly sacrifices her life for her country.;
La madre| A story about a family torn apart by a workers strike. At first, the mother wants to protect her family from the troublemakers, but eventually she realizes that her son is right and the workers should strike.;
Metropolis| In a futuristic city sharply divided between the working class and the city planners, the son of the citys mastermind falls in love with a working class prophet who predicts the coming of a savior to mediate their differences.;
Miss Mend| Three reporters and an office girl are trying to stop a bacteriological strike by some powerful western business leaders against the USSR.;
My Lady of Whims| Clara plays wealthy Prudence Severin, whose reckless, profligate behavior causes nothing but headaches for her father. A detective Lee Moran is hired to protect Prudence from herself, but to no avail.;
Namus| Young lovers Seyran and Susan meet a tragic fate because of patriarchal prejudices of their parents. Although arranged for marriage in early childhood, and despite youngsters love, ...;
Nan| When the vivacious and beautiful Nana bombs at the Thtre des Varits, she embarks on the life of a courtesan, using her allure and charisma to entice and pleasure men.;
Nell Gwyn| An actress becomes the kings mistress and persuades him to convert the palace to a servicemans home.;
Old Ironsides| An American fighting ship battles Barbary pirates in the Mediterranean in the 18th century.;
Secondo la legge| A fiveperson team of gold prospectors in the Yukon has just begun to enjoy great success when one of the members snaps, and suddenly kills two of the others. The two survivors, a husband ...;
Protsess o tryokh millionakh| Who is a thief  a street pickpocket, a social lion or a banker The thief is the one who takes it small, the man with prospects is called a winner.;
The Road to Mandalay| A former captain tries to reunite with his daughter, twenty years after leaving her as an infant.;
Der Rosenkavalier| While her husband illustrated himself in the war, the Marchale de Werdenberg took comfort in the arms of the young Octavian and tried to arrange the affairs of his cousin, the Baron Ochs, by introducing him to a young girl;
La lettera rossa| After having a child out of wedlock, a young Puritan woman is pressured to reveal the name of her lover.;
Il mostro del mare| This silent movie is based on Melvilles classic Moby Dick. Ahab and his brother compete for the affections of ministers daughter Esther. But the great white whale has been eluding the ...;
La corsa a ostacoli di Shamrock| The story of Sir Miles OHara and his daughter, who rent out living quarters to a poor family, the OSheas, who cannot pay rent on time.;
Shinel| One of the most acknowledged film interpretations of classic short story The Overcoat 1842 by Nikolai Gogol, describing a fate of a small person.;
The ShowOff| A blowhard who poses as a railroad executive but is really just a 30aweek clerk catches a young bride and then drives her familys finances to the brink of ruin.;
La vita  un charleston| The first movie to ever depict a choreographed dance scene in a silent movie. The Charleston;
Sos Your Old Man| Poor glazier Sam Bisbee has invented breakproof glass. He intends to show it off to a convention of automobile men. Due to a mixup his car is switched with another and his demonstration ...;
Il figlio dello sceicco| The son of the sheik and a dancing girl fall in love, but when he is made to believe she has betrayed him he seeks revenge.;
The Sorrows of Satan| Geoffrey, a young and impoverished writer, is desperately in love with Mavis, who lives at his boardinghouse and is also pursuing a writing career. Unable to marry her because of his ...;
Passerotti| Molly, the eldest child at a baby farm hidden deep in a swamp, must rescue the others when their cruel master decides that one of them will be disposed of.;
La grande sparata| A meek Belgian soldier, fighting in World War I, receives a letter and a photo from Mary Brown, an American girl he has never met. After the war, he travels to America searching for her.;
Der Student von Prag| For Balduin, going out to beer parties with his fellow students and fighting out disputes at the tip of the sword have lost their charms. He wants to find love but how would he, a ...;
Tartufo| A young man shows his millionaire grandfather a film based on Molires Tartuffe, in order to expose the old mans hypocritical governess who covets his own inheritance.;
La tentatrice| An architect tries suppressing his passion for a seductive woman.;
I tre furfanti| Three outlaws come to the aid of a young girl after her father is killed.;
Torrent| A young girl and her father are kicked out of their house by a cruel noblewoman, and the girls heart is broken when her sweetheart, the noblewomans son, wont go to Paris with them. After...;
Di corsa dietro un cuore| Lowlife Harry falls in love with sweet Betty who inspires him to improve himself so he can marry her. He enters a 25,000 crosscountry hiking contest. After many adventures he wins, pays ...;
The Volga Boatman| During the Revolution Princess Vera, though betrothed to Prince Dimitri, is attracted to the peasant Feodor.;
Lallievo di West Point| Wealthy Brice Wayne enters West Point and, though he does well on the football field, angers fellow cadets with his arrogance. Disciplined by the coach he yells To hell with the Corps ...;
Gloria| U.S. Marine sergeants Quirt and Flagg are inveterate romantic rivals on peacetime assignments in China and the Philippines. In 1917, W.W. I brings them to France, where Flagg, now a captain...;
Fiore del deserto| While building an irrigation system for a Southwestern desert community, an engineer vies with a local cowboy for the affections of a ranchers daughter.;
Almost Human| John Livingston is a rich mamasboy, who owns a blooded dog named Paul. Paul meets Maggie Mutt, and Paul, being a pedigree canine and somewhat of a cad, lures trusting Maggie to the barn ...;
La mandragora| A scientist interested in the laws of heredity, impregnates a prostitute in a laboratory with the semen of a hanged murderer. The prostitute conceives a female child who has no concept of love, whom the professor adopts.;
Annie Laurie| The story of the famous battle between the Scots clans of Macdonald and Campbell, and the young woman who comes between them, Annie Laurie.;
Baby ryazanskie| Orphan Anna lives with her aunt Aliona in the Russian district of Ryazan. One day, they meet Wassily and his son Ivan. In order to marry off his son, Wassily organizes a meeting with all ...;
Barbed Wire| During WWI, a French farm girl and a German P.O.W. fall in love.;
The Beloved Rogue| Franois Villon, in his lifetime the most renowned poet in France, is also a prankster, an occasional criminal, and an ardent patriot.;
Caf Elektric| A dancehall girl falls for a pickpocket.;
Captain Salvation| A returning seminary student goes up against a small New England town when he comes to the aid of a prostitute who has been injured, despite the townspeoples calls for her to be run out of...;
Casanova| A flamboyant portrait of the famous seducer seen by a former baritone of the Moscow Opera who, after a vocal accident, leaves for Germany and then France to devote himself to cinema.;
Il castello degli spettri| Relatives of an eccentric millionaire gather in his spooky mansion on the 20th anniversary of his death for the reading of his will.;
Chicago| A wild jazzloving and boozing wife Roxie Hart, kills her boyfriend in cold blood after he leaves her.;
I figli del divorzio| A young flapper tricks her childhood sweetheart into marrying her. He really loves another woman, but didnt marry her for fear the marriage would end in divorce, like his parents. Complications ensue.;
Tuo per sempre| To reconcile with his girlfriend, a bookish college student tries to become an athlete.;
La ragazza con la cappelliera| Natasha and her grandfather live in a cottage near Moscow, making hats for Madame Irne. Madame and her husband have told the housing committee that Natasha rents a room from them this ...;
Il declino| Public schoolboy Roddy Berwick is expelled from school when he takes the blame for a friends charge and his life falls apart in a series of misadventures.;
Latleta innamorato| College football player Jack Hamill finds his reputation on the line when he pays an innocent visit to a woman whose husband kills himself.;
Fragile virt| A recently divorced woman hides her scandalous past from her new husband and his family.;
The Fair CoEd| Marion goes to college to pursue a handsome young man and discovers that he is coach of a womens basketball team.;
The First Auto| Hank owns horses, stables horses and races horses. He favorite horse always wins and he is prosperous and will known. His son Bob, however dreams only of the future of the horseless ...;
The Gaucho| A girl is saved by a miracle after she falls from a cliff in the Argentine Andes, and is blessed with healing powers. A shrine is built on the site, and a whole city grows around it, rich ...;
Come vinsi la guerra| When Union spies steal an engineers beloved locomotive, he pursues it singlehandedly and straight through enemy lines.;
Get Your Man| A young American girl in Paris falls in love with a handsome nobleman, but he is about to wed in an arranged marriage. She hatches a plan to overcome that obstacle and get her man.;
La glace  trois faces| Psychological narrative avantgarde film about a wealthy young businessman who consecutively falls in love with a classy English woman Pearl, a Russian sculptress Athalia, and a naive ...;
La Felicit| A hapless man undergoes misadventures with avaricious clergy, a tired horse, and a walking granary on his road to collectivized happiness.;
Hindle Wakes| A celebration of working class leisure activities at Hindle, Lancashire, during Wakes Week, an annual week still observed in parts of Lancashire and Yorkshire when all factories and ...;
Hotel Imperial| During World War I, a hotel maid and Austrian officer in hiding attempt to survive in a Russianoccupied town.;
Hula| The daughter of a pineapple plantation owner in Hawaii sets her sights on a married English engineer.;
Cosetta| A salesgirl with plenty of it sex appeal pursues a handsome playboy.;
Il cantante di jazz| The son of a Jewish Cantor must defy the traditions of his religious father in order to pursue his dream of becoming a jazz singer.;
Le joueur dchecs| In 1776, an inventor conceals a Polish nobleman in his chessplaying automaton, a machine whose fame leads it to the court of the Russian empress.;
Il fratello minore| A sheriffs milquetoast son has a chance to prove himself when a medicine show run by con artists comes into town.;
Il re dei re| Jesus Christ faces religious and political oppression during his ministry and in the days before his death and resurrection.;
La fine di San Pietroburgo| A peasant comes to St. Petersburg to find work. He unwittingly helps in the arrest of an old friend who is now a labor leader. The unemployed man is arrested and sent to fight in World War I. After three years, he returns to rebel.;
Il Giglio nelle tenebre| In the Crimea, the Reds and the Whites arent done fighting, and Jeanne discovers that the man she loves is a Bolshevik when he kills her father. Penniless, she returns to Paris where she...;
Il fantasma del castello| The abandoned home of a wealthy man who supposedly committed suicide five years earlier is taken over by ghoulish figures  could they be vampires;
Le sue ultime mutandine| Harry Shelby receives his first pair of long pants. He immediately falls in love with a cocainesmuggling flapper named Bebe. When Bebe is imprisoned, Harry decides to rescue her. To do so,...;
Anna Karenina| A married woman compromises her social standing and family life when she falls for a young officer.;
The Love of Sunya| A young woman at lifes crossroads is granted mystic visions of how her decisions will affect her future life.;
Man, Woman and Sin| A young man takes a succession of odd jobs in order to save enough money to buy he and his mother a house. He lands a position in a newspaper office and falls in love with the beautiful ...;
Mockery| During the Russian Revolution, a mentally challenged peasant saves then obsesses over a beautiful countess.;
Mr. Wu| When Mandarin Wus unmarried daughter becomes pregnant by a young Englishman, he seeks vengeance.;
My Best Girl| A department stores stock girl falls in love with a coworker, the son of the stores manager the feeling is mutual though he is engaged to a debutante and focusing on becoming successful without the influence of his father.;
Napoleone| A film about the French generals youth and early military career.;
Ottobre| A largescale view on the events of 1917 in Russia, when the monarchy was overthrown.;
Il re del sottosuolo| In San Francisco, a villainous land owner with underworld connections seeks to steal the property of an old Spanish family.;
Il mio cuore aveva ragione| A telephone operator at an opulent hotel falls in love with a young man who turns out to be a rich oil millionaire.;
Passione di principe| An American banker goes to a small Balkan country looking to invest his banks money and shore up the countrys weak economy in order to maximize the return on their investment. Towards ...;
Ferro e fuoco| A boxer has difficulty balancing his sport with a budding romance both are further jeopardized when the United States enters the first World War.;
Potseluy Meri Pikford| Goga is a Russian man who has no luck with women. He has a chance meeting with Mary Pickford. She kisses him in full view of several and he instantly becomes attractive to them. They chase ...;
Quality Street| A fresh young beauty becomes an old maid waiting for her suitor to return from the Napoleonic wars. When he returns, clearly disappointed, she disguises herself as her own niece in order to test his loyalty.;
The Red Mill| A tavern worker and the daughter of a burgomaster enter into elaborate masquerades in order to win the hearts of the men they love.;
Vinci per me| Two boxers compete for the love of a woman.;
Running Wild| Cowardly Elmer Finch is browbeaten by his wife, daughter, fat son and the family dog. After hypnosis he is domineering. He enters a contract with a fifteenthousand dollar payoff, so his ...;
The Scar of Shame| An educated, upscale young black musician marries a woman from a lower socioeconomic class to get her out of the clutches of her stepfather, who beats and abuses her. However, once he ...;
Settimo cielo| A street cleaner saves a young womans life, and the pair slowly fall in love until war intervenes.;
A Ship Comes In| An immigrant family experiences life in the United States.;
Shooting Stars| The husband and wife acting team of Mae Feather and Julian Gordon is torn apart when he discovers she is having an affair with the screen comedian Andy Wilks. Mae hatches a plot to kill her...;
The Show| Performers in a Budapest sideshow encounter love, greed, and murder.;
Slide, Kelly, Slide|  NA;
Spring Fever| To impress a wealthy young woman, a clerk pretends he is a progolfer.;
Il principe studente| A cloistered, overprotected Austrian prince falls in love with a downtoearth barmaid in this Viennese fairy tale.;
Sumka dipkuryera| The true murder of the Soviet diplomat Teodor Nette, which narrates the difficulties in returning the diplomatic bag of the murdered agent to Russia, by sea and before it is found by the British secret police.;
Aurora| An allegorical tale about a man fighting the good and evil within him. Both sides are made flesh  one a sophisticated woman he is attracted to and the other his wife.;
Tarzan and the Golden Lion| Flora Hawks is in love with the overseer of Tarzans African estate. After a search for a legendary city of diamonds, Tarzon races with his pet lion Jadbalja to save Haws from being sacrificed to a liongod.;
Tell It to the Marines| A gruff Marine sergeant and a handsome new recruit compete for the affection of a nurse.;
Threes a Crowd|  NA;
Tillie the Toiler| Tillie the Toiler is a 1927 silent film comedy produced by Cosmopolitan Productions and released through Metro Goldwyn Mayer studios. It is based on Russ Westovers popular comic strip ...;
Tretya meshchanskaya| A married couple have a small apartment in Moscow. When an old friend of the husbands arrives in the city, he is unable to find lodgings. Kolia, the husband, invites his friend to move in with them.;
Twelve Miles Out| Jerry always wins in his rivalry with Red over women, gunrunning, and diamond smuggling. While running booze into the U.S. during Prohibition, Jerry seizes Janes seaside home. When she ...;
Notte dArabia| Two American soldiers are captured by the Germans on the Western Front during World War One and escape a POW camp only to stumble into further lifethreatening adventures when they come across an Arabian kings daughter while on the lam.;
Un cappello di paglia di Firenze| On his way through the woods to his marriage, Fadinards horse eats the hat of a married lady spending here a few moments with her lover. Fadinard has to find the very same rare hat to ...;
Uncle Toms Cabin| Slavery tears apart a black family in the South before the start of the Civil War.;
Le notti di Chicago| Boisterous gangster kingpin Bull Weed rehabilitates his former lawyer from his alcoholic haze, but complications arise when he falls for Weeds girlfriend.;
Lo sconosciuto| A criminal on the run hides in a circus and seeks to possess the daughter of the ringmaster at any cost.;
Controcorrente| Among the residents of a theatrical boarding house is the last member of a once great acting family, down on his luck. When an offer to star in a London Hamlet comes, he takes lessons ...;
When a Man Loves| A nobleman studying for the priesthood abandons his vocation in 18th Century France when he falls in love with a beautiful, but reluctant, courtesan.;
Ali| Two young men, one rich, one middle class, who are in love with the same woman, become fighter pilots in World War I.;
Winners of the Wilderness| Able wilderness fighter Colonel OHara loves Rene, daughter of the commander of the French forces during the French and Indian War. The Indians, under Pontiac, kidnap Rene. OHara hopes to rescue and wed her.;
Enigma| On his honeymoon with a bride he has wed for business reasons, a man falls for a woman who is in the clutches of a sinister character.After this woman begs him to help her escape, he plots to do so using the opportunity of a masked ball.;
Xi xiang ji| A famous Chinese story about a young couple who consummate their marriage without the approval of their parents.;
Crisi| Neglected by her husband, an ambitious lawyer, Irene seeks variety in Berlins nightlife, drugs and flirtations included.;
Amore e mare| Conflict ensues when a young mans childhood sweetheart becomes betrothed to his older brother.;
La battaglia dei sessi| Gumchewing frizzyhaired golddigger Marie Skinner cooks up a scheme with her lover Babe Winsor, a jazz hound, to fleece a portly, middleaged real estate tycoon, William Judson. Marie ...;
I mendicanti della vita| After killing her treacherous stepfather, a girl tries to escape the country with a young vagabond. She dresses as a boy, they hop freight trains, quarrel with a group of hobos, and steal ...;
Bringing Up Father| The wealthy Jiggs is tired of being left out of the swanky parties thrown by his socialclimbing wife Maggie and their daughter. He decides to teach them a lesson by faking his own ...;
Il vaso di Pandora| The rise and inevitable fall of an amoral but naive young woman whose insouciant eroticism inspires lust and violence in those around her.;
Il cameraman| Hopelessly in love with a woman working at MGM Studios, a clumsy man attempts to become a motion picture cameraman to be close to the object of his desire.;
Il fidanzato di cartone| A ditzy American girl visiting Monte Carlo is hired by a tennis champ to be his cardboard loverto pretend to be in love with him so he can teach his twotiming fianc a lesson and win ...;
Tabarin di lusso| A spoiled heiress defies her father by running off to marry her lover. However, Daddy has a few tricks up his sleeve.;
La caduta della casa Usher| Allan visits the sinister Usher family mansion, where his friend Roderick is painting a portrait of his sickly wife Madeline. The portrait seems to be draining the life out of Madeline, slowly leading to her death.;
Il circo| The Tramp finds work and the girl of his dreams at a circus.;
I cosacchi| A peaceloving Cossack chooses to prove himself in battle when his village and childhood sweetheart label him a coward.;
I due timidi| Garadoux has beaten his wife. His lawyer Fremissin is young and very shy, and therefore, not very efficient... Two years after, Garadoux is trying to seduce Cecile, but she prefers ...;
La donna divina| For 9 minute surviving fragment Lucian, a soldier in Paris, is to ship out for Algiers at 9 that evening. He stops by for a last meal with his love, Marianne. He may be worried that when ...;
I dannati delloceano| A bluecollar worker on New Yorks depressed waterfront finds his life changed after he saves a woman attempting suicide.;
La casa sulla Trubnaja| A girl Parasha Pitunova comes to Moscow from a deep province, eventually she arrives at a house. This is a story about the house and its inhabitants.;
Eliso| Two members of opposing villages fall in love.;
La moglie del fattore| After his daughter weds, a middleaged widower with a profitable farm decides to remarry, but finds choosing a suitable mate a problematic process.;
Oasi dellamore| An Arab prince born and raised in the desert and a beautiful Frenchwoman from Paris fall in love and marry, but the tremendous differences in their backgrounds and the cultural differences between their two different societies put strains on their marriage that may well prove irreparable.;
Tastatemi il polso| A rich but hypochondriac heiress inherits a sanitarium. What she doesnt know is that it is a front for bootleggers, and a hideout for criminals on the run from the law.;
I quattro diavoli| Four orphans, raised by an aging clown, becomes a high wire act in a circus.;
The Four Feathers| When British officer Harry resigns from his regiment, he is labeled a coward by his family and friends. Harry receives four white feathers as a mark of a coward. In order to redeem himself ...;
Lultima gioia| A family saga in which three of a Bavarian widows sons go to war for Germany and the fourth goes to America, Germanys eventual opponent.;
Quattro mura| While Benny is in jail his old henchman Monk takes over the gang and Bennys girl Frieda. Once out Benny wants nothing to do with either. He has reformed and is beloved of his godfearing ...;
Eden palace| Toni Le Brun, a beautiful Viennese singer, becomes the ward of the wardrobe mistress of a Monte Carlo nightclub. Her benefactor, however, is actually a baroness incognito. Toni falls in ...;
Sesso Incatenato| A young man is convicted of manslaughter and sentenced to a term in prison. There he forms a close relationship with his cellmate and upon his release his wife is concerned as to how prison has changed the man she married.;
Capitan Barbabl| Two sailors with a rivalry over chasing women become friends. But when one decides to finally settle down, will this mysterious young women come between them;
La casa del boia| Citizen Hogan, an exile Irish patriot, risks his life by returning to Ireland and helping a young couple.;
Heimkehr| Following World War I, after a long imprisonment, two German prisonerofwar soldiers escape from a Siberian leadmine. Karl manages to reach Germany before Richard, and is sheltered by ...;
High Treason| Women unite to prevent financiers from engineering a second world war.;
Jjiro| After falling in love with a courtesan, Rikiya is blinded by ash during a fight in a brothel. Believing the blindness permanent and his opponent dead, Rikiya goes back home to his sister. ...;
Lavventuriera| Seasoned grifter Dolly Crandall returns to the badger game but has a change of heart when she falls in love with a young man she believes is a rich Southerner.;
Crepuscolo di gloria| A former Imperial Russian general and cousin of the Czar ends up in Hollywood as an extra in a movie directed by a former revolutionary.;
Ridi pagliaccio| A professional clown and a selfindulgent count learn to help each other with their problems, but then become romantic rivals.;
Lights of New York| Two men are conned into bootlegging business.;
Le sette aquile| All of those handsome young men in their flying machines are billeted in a field next to the Widow Berthelots farmhouse in France. Her daughter Jeannine is curious about the young men ...;
Primo amore| Two lonely people in the big city meet and enjoy the thrills of an amusement park, only to lose each other in the crowd after spending a great day together. Will they ever see each other again;
Maldone| Maldone is a canal worker, happy with his life after running away from his family estate. He falls in love with Zita, a young gypsy girl, during a local fete. However, after his brother ...;
Luomo che ride| When a proud noble refuses to kiss the hand of the despotic King James in 1690, he is cruelly executed and his son surgically disfigured.;
Il teatro di Minnie| A Broadway matinee idol famous for his blackface portrayals anonymously joins an amateur acting troupe and falls in love with the leading lady.;
The Mating Call| A WWI vet takes on the KKK when he loses his wife to a womanizing Klansman.;
La canzone della mamma| Ellen McHugh, a poor Irish immigrant to America, finds work in a carnival and is thus able to send her son Brian to a fine school. But when her position is found out, the school expels ...;
Moulin Rouge| Parysia is the rage of Paris. She has a daughter, secretly engaged to Andre, and the boys aristocratic father objects to the alliance because of Margarets mother being a revue artist. ...;
La donna misteriosa| An attractive Russian spy seduces an Austrian officer in order to get some important plans, but when she actually falls in love with him, both of them are placed in a dangerous situation.;
Le nostre sorelle di danza| A flapper whos secretly a good girl and a gold digging floozy masquerading as an ingnue both vie for the hand of a millionaire.;
La passione di Giovanna dArco| In 1431, Jeanne dArc is placed on trial on charges of heresy. The ecclesiastical jurists attempt to force Jeanne to recant her claims of holy visions.;
Fascino biondo| An awkward teenager hopelessly in love with her elder sisters boyfriend tries to make him notice her.;
Tempeste sullAsia| After a runin with the law, a Mongolian man becomes a fugitive and joins the Russian Civil War.;
Il potere della stampa| The naive newspaper cub Clem lands a scoop when hes sent out to cover a murder. In his enthusiasm he writes that the main suspect is Jane. When she confronts Clem she convinces him to help her prove her innocence.;
The Racket| An honest police captain vows to bring down a powerful bootlegger who is protected by corrupt politicians and judges.;
La danzatrice rossa| Note Contains Spoilers  The story, set in Russia at the time of the Bolshevik Revolution, focuses on the relationship between three characters Tasia Dolores del Rio, a peasant girl ...;
Riley the Cop| Joe Smith, a young bakery worker, gets engaged to Mary Coronelli, who comes from a wealthy family. Her snooty aunt takes Mary to Europe, hoping to break up the couple, but Joe uses his ...;
RoseMarie| Sergeant Malone of the Mounties and effeminate Etienne Doray are both in love with RoseMarie, but she doesnt light up until soldier of fortune Jim Kenyon drifts into the post. Soon Jim is...;
Tristana e la maschera| A prostitute seeking a fresh start becomes the obsession of a religious extremist.;
Shiraz| A historical romance set in the Mughal Empire. Selima Enakshi is a princessfoundling raised by a potter and loved by her brother, Shiraz Rai. She is abducted and sold as a slave to ...;
Maschere di celluloide| A young lady from Georgia goes to Hollywood in the hopes of becoming an actress.;
Il cantante pazzo| A singing waiter and composer Al Jolson loves two women Betty Bronson, Josephine Dunn, conquers Broadway and holds his dying son, singing Sonny Boy.;
The Smart Set| An American polo player, arrogant and full of himself, must vindicate his actions to win the heart of a girl, Polly, after getting himself booted off the U.S. polo team.;
A rotta di collo| Harold Speedy Swift, a fan of;
Linafferrabile| The mastermind behind a ubiquitous spy operation learns of a dangerous romance between a Russian lady in his employ and a dashing agent from the governments secret service.;
Io... e il ciclone| The effete son of a cantankerous riverboat captain comes to join his fathers crew.;
Langelo della strada| A woman on the run from the law finds her past catching up to her just as she is on the verge of true happiness.;
Femmine del mare| Two sailors who are always competing against each other set their sights on the same girl. When she chooses one over the other, their friendship ends acrimoniously. However, things change ...;
Nella tempesta| In Czarist Russia, a peasant officer, resented by the aristocrats, falls in love with a princess.;
Quella certa cosa| Molly Kelly wants to marry a millionaire. When she runs into Andy Charles, heir to a restaurant fortune, she jumps at the chance and marries him. Andys father if furious and disinherits ...;
Tire au flanc| A rich poet and his servant both join the army and wind up in the same barracks.;
The Trail of 98| Fortune hunters from all over the country rush to the Klondike in 1897 to seek their fortunes in the gold are tested by hardships of the journey.;
Underground| A workingclass love story set in and around the London Underground of the 1920s. Two men  gentle Bill and brash Bert  meet and are attracted to the same woman on the same day at the same...;
I vichinghi| Vikings compete for power and the love of a woman.;
Nel gorgo del peccato| After a robbery, a happy bank clerk loses own identity and has been presumed dead.;
Il fiume stanco| A gangster is put in prison, but finds salvation through music while serving his time. Again on the outside, he finds success elusive and temptations abound.;
Sinfonia nuziale| A young impoverished aristocrat falls in love with an innkeepers daughter, but has to marry money.;
La serpe di Zanzibar| A magician seeks vengeance upon the man who paralyzed him and the illegitimate daughter he sired with the magicians wife.;
Mentre la citt dorme| A tough New York cop is determined to bring down a crook who has always managed to provide an alibi for the crimes hes been accused of, even though the detective knows hes guilty of committing them.;
Ombre bianche| An alcoholic doctor on a Polynesian island, disgusted by white exploitation of the natives, finds himself marooned on a pristinely beautiful island.;
Il vento| A frail young woman from the east moves in with her cousin in the west, where she causes tension within the family and is slowly driven mad.;
Il destino| When two childhood sweethearts are kept from marrying, misery ensues.;
Il cadavere vivente| Fjodor Protassow wants to divorce his wife, so that she can be happy with another man. But the church wont allow a divorce, so he fakes his own death, becoming a living corpse.;
Zvenigora| An old Ukrainian man protects and searches for a legendary treasure in the midst of political upheavals.;
La aldea maldita| In an impoverished Castilian village live Juan, his wife Acacia, their son and Juans blind father. The harsh weather conditions force the peasants to emigrate to a better land. Acacia goes...;
Alibi| Chick Williams, a prohibition gangster, rejoins his mob soon after being released from prison. When a policeman is murdered during a robbery, he falls under suspicion. The gangster took ...;
Applause| A burlesque star seeks to keep her conventraised daughter away from her lowdown life and abusive loverstage manager.;
Largent| The business tycoon Nicolas Saccard is nearly ruined by his rival Gunderman, when he tries to raise capital for his company. To push up the price of his stock, Saccard plans a publicity ...;
Arsenale| A soldier returns to Kiev after surviving a train crash and encounters clashes between nationalists and collectivists.;
Asfalto| Joe Mays sensual drama of life in the Berlin underworld is in many ways the perfect summation of German filmmaking in the silent era a dazzling visual style, a psychological approach to ...;
Atlantic| On its maiden voyage in April 1912, the supposedly unsinkable RMS Titanic hits an iceberg in the Atlantic Ocean.;
Behind That Curtain| Eve Mannering realizes too late that her abusive husband is a philanderer and murderer and seeks protection with her true love, explorer John Beetham.;
Big News| A reporters marriage is jeopardized by his drinking and he finds himself accused of a murder he didnt commit.;
La guardia nera| Captain Donald King of the British Army goes to India just as World War I breaks out, convincing his comrades that he is a coward. In reality, he is on a secret mission to rescue British ...;
Ricatto| After killing a man in selfdefense, a young woman is blackmailed by a witness to the killing.;
Broadway| A naive young dancer in a Broadway show innocently gets involved in backstage bootlegging and murder.;
Ragazze dAmerica| A Chorus girl who is in love with her stage manager is led to believe that he is in love with another young woman, so, she agrees to marry a bootlegger instead.;
La canzone di Broadway| A pair of sisters from the vaudeville circuit try to make it big time on Broadway, but matters of the heart complicate the attempt.;
Cercasi avventura| A bored WWI veteran helps out a young woman, whose uncle is being held hostage by embezzlers.;
La Canarina Assassinata| A beautiful showgirl, nicknamed the Canary, is a scheming nightclub singer. Blackmailing is her game and soon ends up dead. But who killed the Canary. All the suspects who knew her had ...;
Le capitaine Fracasse| Capt. Fracasse, a downonhisluck nobleman, gives shelter at his estate one night to a troupe of traveling actors. He falls in love with Isabelle, an actress with the group. The next day, ...;
The Cocoanuts| During the Florida land boom,;
Lisola del diavolo| Suave thief Colman is sent to Devils Island, where he becomes romantically involved with the wife of sadistic warden Digges.;
Coquette| A flirtatious Southern belle is compromised with one of her suitors.;
Daigaku wa detakeredo| Feeling the position to be beneath him, a college graduate turns down a receptionist job, but soon finds it necessary to fool his mother and fianc into thinking that he is employed.;
La danza della vita| A vaudeville comic and a pretty young dancer arent having much luck in their separate careers, so they decide to combine their acts and in order to save money on the road, they get married.;
Funamboli| A young bareback rider in a circus is in love with a trapeze artist, but he has two problems he drinks too much and hes fallen under the spell of a vamp whos nothing but trouble for him.;
Notti nel deserto| A con man and his beautiful accomplice kidnap a manager and steal 500,000 worth of diamonds, but end up stranded in the desert without water.;
Il tenente di Napoleone| A Bonapartist falls for a Royalist.;
Disraeli| Prime Minister of Great Britain Benjamin Disraeli outwits the subterfuge of the Russians and chicanery at home in order to secure the purchase of the Suez Canal.;
Trafalgar| The story of the romance between Emma, Lady Hamilton, and British war hero Admiral Horatio Nelson.;
The Duke Steps Out| Millionaires son Duke wants to be a champion boxer but takes time out to enroll in college when he sees coed Susie. The students wonder about his having a chauffeur and house full of ...;
Dinamite| Wealthy Cynthia is in love with notsowealthy Roger, who is married to Marcia. The threesome is terribly modern about the situation, and Marcia will gladly divorce Roger if Cynthia agrees ...;
Erotikon| A young woman is seduced and abandoned by a man who was invited to stay at his home by her father in a stormy night. Noticing that she is pregnant, the girl decides to leave home and start a new life.;
La valanga| In the Swiss Alps of the early 19th century, a couple forced into loveless marriages struggle to find happiness with one another.;
Evangelina| In Acadia, now part of the Canadian province of Nova Scotia, young Evangeline is betrothed to Gabriel. But before their wedding can take place, the British imprison the men and send them ...;
Diavoli volanti| A Marine flyer and his flight school mentor fall for the same beautiful nurse.;
La flotta del cielo| The story follows six midshipman after they graduate from Annapolis. Their goal is to become U.S. Navy pilots and three of them are eliminated at the San Diego Naval Base. The remaining ...;
The Flying Scotsman| A young fireman on the Flying Scotsman train falls in love with the beautiful daughter of the driver who is about to retire. The young fireman has replaced another named Crow who was sacked...;
Una donna nella luna| A tenacious scientist blasts off for the moon in hopes of riches that may be found there.;
Frulein Else| A young woman reluctantly decides to compromise her values in order to save her family from bankruptcy and disgrace.;
The Girl in the Show|  NA;
Glorifying the American Girl| The rise of a showgirl, Gloria Hughes, culminating in a Ziegfeld extravaganza Glorifying the American Girl.;
Donna pagana| Two teenagers, one an atheist and the other a Christian, fall in love at a brutal reform school.;
Gold Diggers of Broadway| Three Broadway chorus girls seek rich husbands.;
Goluboy ekspress| In a train where social classes are strictly separated wealthy in the front, poor in the back, a revolt erupts.;
Il bandito e la signorina| Steven Ghent has decided to sell the mine hes owned for fifteen years, located at the border of Mexico where the Great Divide ends. When the representatives are delayed for a few days, he ...;
Il gran Gabbo| An insanely, egocentric ventriloquist, even though he is possessed by his wooden dummy, is in love with a dancer who is in love with another. The dummy gives advice to the ventriloquist.;
The Greene Murder Case| At the end of each year, the extremely wealthy but odious Greene family gets together at the spooky old family castle to establish terms of a will, though they despise each other. This year...;
Half Marriage| A young couple marries in secret. Judys afraid her parents wont approve of Dick and shell lose her generous allowance. Her parents bring her home from the city where shes been studying ...;
Alleluja| A sharecropper decides to become a preacher after falling for a vamp from the city.;
Gli eroi del deserto| When three men rob a bank, a guard is killed and the three bandits escape into the desert where they lose their horses in a storm. Finding a woman who gives birth, they are made godfathers ...;
Her Private Affair| Her Private Affair is a 1929 drama film directed by Paul L. Stein and starring Ann Harding. It was produced and distributed by the Path Exchange company. It is a sound film using the RCA Photophone soundonfilm sound system.;
High Voltage| A busload of passengers gets stranded in a snowstorm and take refuge in an abandoned church, where they run into a mysterious man who may be on the run from the law.;
The Hole in the Wall| Mrs. Ramsey sent Jean Oliver to prison on a false charge. To get even, Jean disguised as Madame Mystera plans to kidnap her daughter and turn her into a thief. Love entanglements with a ...;
Hollywood che canta| An allstar revue featuring MGM contract players.;
Sette passi verso Satana| A young man of society wants to make an expedition to Africa, but his fiance asks him for help about one of her fathers guests shortly before his planed departure. Her suspects about that ...;
Il bacillo dellamore| Laurence Gerard has just divorced. While leading fat lover Talandier by the nose, She meets the count Lerski, who now works as waiter but do not tell her. When she hears from her husband he...;
The Idle Rich| Millionaire William van Luyn falls in love with his secretary Joan Thayer and marries her. Her family, part of the great middle class as blowhard nephew Henry keeps reminding us, is ...;
Notte di tradimento| A charming, happygolucky bandit in old Arizona plays catandmouse with the sheriff trying to catch him while he romances a local beauty.;
The Informer| In Ireland, an IRA man betrays a killer to the police, thinking he is his mistresss lover.;
La maschera di ferro| King Louis XIII of France is thrilled to have born to him a son  an heir to the throne. But when the queen delivers a twin, Cardinal Richelieu sees the second son as a potential for ...;
La romanza dellamore| Casey and Babe are sisters who work in a department store and each year the store puts on a show. As expected, things are going wrong with every act until Casey comes out to help Babe with ...;
Il bacio| An unhappily married woman is caught up in scandal and murder when her affection toward a young man is misinterpreted.;
Laila, la figlia del nord| A spirited Norwegian Lass is torn between two suitors and two cultures.;
Erik il grande| A middleaged magician is in love with his beautiful young assistant. She, on the other hand, is in love with the magicians young protege, who turns out to be a bum and a thief.;
The Last Warning| A producer decides to reopen a theater, that had been closed five years previously when one of the actors was murdered during a performance, by staging a production of the same play with ...;
Lonest della signora Cheyney| There is a big charity function at the house of Mrs. Cheyney and a lot of society is present. With her rich husband, deceased, rich old Lord Elton and playboy Lord Arthur Dilling are both ...;
The Letter| Jeanne Eagels plays the bored and restless Leslie Crosbie who turns to another man, Geoffrey Hammond Herbert Marshall for attention when neglected by her husband Robert Reginald Owen. ...;
Linda| Circumstances force a young woman to marry a much older man, although she really loves a young doctor.;
La porta chiusa| On her first anniversary Ann Reagan finds that her sisterinlaw is involved with a shady character from her own past, and determines to intervene.;
Il principe consorte| The queen of mythical Sylvania marries a courtier, who finds his new life unsatisfying.;
Trappola damore| A chorus girl loses her job and thus the room she owes back rent on, and ends up being rescued from the street by a dashing rich man. But his family isnt overaccepting of chorus girls joining their family.;
La stella della fortuna| Mary, a poor farm girl, meets Tim just as word comes that war has been declared. Tim enlists in the army and goes to the battlefields of Europe, where he is wounded and loses the use of his...;
Madame X| A young lawyer unknowingly defends his mother who abandoned him when he was three.;
Lisola del peccato| A fisherman and a rising young lawyer, who grew up as brothers, fall in love with the same girl.;
La compagnia dassalto| During World War I, a young French woman struggles to choose between two suitors a blind soldier to whom she is engaged and an American serviceman.;
Marianne|  NA;
Uomini di domenica| Two men and two women enjoy a pleasant Sunday at the beach amid the unending toil of the working week.;
Rosa del Messico| A drama set in a border town gambling saloon. The owner falls in love with a promiscuous young girl. When she has an affair with another, he tosses her out of town. She gets revenge by marrying his younger brother.;
Il conte di Montecristo| After greedy men have Edmound Dantes unjustly imprisoned for 20 years for innocently delivering a letter entrusted to him, he escapes to get his revenge on them;
Il viaggio di mamma Krausens verso la felicit| Mutter Krause and her children live in the poorer section of Berlins Wedding district. The film depicts the cruelty of poverty and communism as a rescuing force that reaches Mutter Krause and the child too late.;
Il drago rosso| During the Boxer Rebellion in China during the early 20th century, in which a Chinese secret society attacked all westerners and anyone who associated with them, Dr. Fu Manchus wife and ...;
Lisola misteriosa| On a volcanic island near the kingdom of Hetvia rules Count Dakkar, a benevolent leader and scientist who has eliminated class distinction among the islands inhabitants. Dakkar, his ...;
Navy Blues| On shore leave, a young sailor meets and falls in love with a pretty young blonde. He goes home with her to meet her parents, but they dont approve of him at all. Their daughter takes ...;
Notti di New York| A chorus girl with marital woes is pursued by a gangster.;
Larca di No| The Biblical story of Noah and the Great Flood, with a parallel story of soldiers in the First World War.;
Les nouveaux messieurs| A theater electricians love to a ballet dancer is tested when he is elected minister.;
La nuova Babilonia| In the beginning of the industrial revolution, the Paris Commune was established in 1871 against the rich and the powerful, and violently repressed by the army that remained faithful to a ...;
Oblomok imperii| A story of a man who loses his memory during the First World War, regains it 10 years after the Russian Revolution and returns home to a new and alien St. Petersburg.;
On with the Show| A musical advertised as the first 100 natural color, allsinging production. The plot concerns a wideeyed former hatcheck girl who takes the place of a rebellious star.;
Ragazze americane| A flapper charms a diplomat to procure her fianc a career opportunity, while the fianc starts a relationship with her best friend.;
Lisola del sole| A carefree South Seas native falls for the halfcaste ward of a religious white man who desires her for himself.;
Piccadilly| A young Chinese woman, working in the kitchen at a London dance club, is given the chance to become the clubs main act which soon leads to a plot of betrayal, forbidden love and murder.;
Prapancha Pash| Two neighboring Indian kingdoms are ruled by cousins  King Ranjit and King Sohat. Unbeknownst to Ranjit, Sohat is plotting to seize control of his kingdom.;
Prividenie, kotoroe ne vozvrashchaetsya| The Ghost That Never Returns is an outstanding Soviet film by Abram Room, the director of Bed and Sofa 1927. Released to little notice in 1930, it joins other very late silents to show ...;
La regina Kelly| A convent girl is abducted and seduced by a prince before being sent off to a brothel in East Africa.;
The Racketeer| A dapper gangster sponsors an alcoholic violinist in order to win the love of a glamorous divorced socialite.;
Redskin|  NA;
Rio Rita| Capt. James Stewart pursues the bandit The Kinkajou over the Mexican border and falls in love with Rita. He suspects, that her brother is the bandit.;
Il fiume| A nave young man is working on a logging camp beside a turbulent river. When it closes for winter, he opts to stay for the experience. He meets a woman who was the girlfriend to the boss ...;
Arcobaleno| The roadshow troupe of a top Broadway show go crosscountry while taking the audience along on the onstage scenes as well as what happens and is happening back stage of the production. ...;
Rotaie|  NA;
Sally| Sally was an orphan who got her name from the telephone exchange where she was abandoned as a baby. In the orphanage, she discovered the joy of dancing and has been practicing since. ...;
Saluto militare| West Point Cadet John and Annapolis Midshipman Frank focus their fraternal rivalry on the big ArmyNavy football game.;
Lui, lei, laltra| Mayme and sister Janie are salesgirls in Ginsbergs Department Store. Mayme is in love with store clerk Bill, but Janie tries to steal him from her. Hazel, another salesgirl, is Jean Harlows first credited role.;
Seven Keys to Baldpate| A writer, looking for some peace and quiet in order to finish a novel, takes a room at the Baldpate Inn. Peace and quiet are last things he gets, though, as there are some very strange things going on at the establishment.;
Clem, bizzarro monello| Dave Roberts is a professional boxer better at losing in fixed matches than in knocking out his opponents. He turns up in towns and is part of a group who sets up corrupt boxing matches. ...;
Show Boat| A mostly silent version of Edna Ferbers original novel, with some songs from the musical as a lastminute addition;
Rivista delle nazioni| Its 1929. The studio gave the cinema its voice and offered the audiences a chance to see their favorite actors and actresses from the silent screen era. For the first time, they can be ...;
The Silent Enemy| A documentary about the life of Indians in Northern Canada.;
Donna che ama| The wealthy Arden Stuart is bored in a party after refusing the wedding proposal of Tommy Hewlett, she drives her car with her driver to a lonely place. She has one night stand with him ...;
Fatemi la corte| Biff and Eddie are the best of friends. They are college seniors, roommates at the fraternity, and star teammates on the USC football team. Then a flapper named Babs enters the picture. ...;
Der Sonderling|  NA;
Cuori e motori| Bill Whipple is a happygolucky mechanic for MacDonald who thinks that he is the worlds greatest driver and lover. Mac has treated Bill like a son since he took him in. One day at the ...;
Io... e lamore| An unimpressive but well intending man is given the chance to marry a popular actress, of whom he has been a hopeless fan. But what he doesnt realize is that he is being used to make the actress old flame jealous.;
The Squall| The activities of Nubi Myrna Loy, a minxlike, Hungarian gypsy girl who, while on the run from her abusive husband, takes shelter in a farmhouse, where she seduces and holds in thrall all the male members of the family.;
Il vecchio e il nuovo| 100.000.000 peasants  illiterate, poor, hungry. There comes a day when one woman decides that she can live old life no longer. Using ways of new Soviet state and industrial progress she changes life and labor of her village.;
La ragazza del bacio| A homeless and destitute violinist joins a combo to bring it success, but has problems with her love life.;
The Studio Murder Mystery| Philandering actor Richard Hardell is murdered at a movie studio. His jealous wife Blanche, his director Rupert Borka, and a girl he mistreated, Helen MacDonald, all have substantial ...;
Il sorriso della vita| Molly and Bee, sweet young working girls, live in a cheap room over a New York grocery store. Mollys idol, wealthy Jack Cromwell, lives in a Long Island mansion but is markedly less ...;
Il diario di una donna perduta| After falling pregnant to a pharmacist and refusing to marry, a young woman is thrown from her home and sent to a strict girls reform school.;
La bisbetica domata| In sixteenth century Padua, Hortensio loves Bianca, the youngest daughter of Baptista. But Baptista will not allow the two to get married until his eldest daughter, the extremely headstrong...;
Tanned Legs| Peggy and Bill are high society lovebirds, but their marriage plans are put on hold while Peggy spends most of her summer straightening out her wayward parents and her unluckyinlove ...;
Ritorna il sole| Lally is a rich girl whose father writes books and plays Polo. After 23 years of marriage, he decides to divorce his wife, and marry Mrs. Chevers. This sours Lally on all men, while on ...;
They Had to See Paris| Oklahoma mechanic Pike Peters finds himself part owner of an oil field. His wife Idy, hitherto content, decides the family must go to Paris to get culture and meet the right kind of ...;
The Thirteenth Chair| Although his murdered friend was by all accounts a scoundrel a true bounder Edward Wales is determined to trap his killer by staging a seance using a famous medium. Many of the 13 seance ...;
La mazzata| A criminal known as Thunderbolt is imprisoned and facing execution. Into the next cell is placed Bob Moran, an innocent man who has been framed and who is in love with Thunderbolts girl. ...;
Londata dei forti| Californias gold dicovery in 1848 draws a tide of empire to the area, which becomes ripe for bandits.;
Tky kshinkyoku| A classic melodramatic love tragedy addressing social inequality in feudal Japan, depicted in Kenji Mizoguchis typical style. The nostalgic scenes of 1920s Tokyo provides a valuable visual...;
Lintrusa| The trial and tribulations of a strongwilled woman who elopes and gives birth out of wedlock without telling her exhusband.;
The Trial of Mary Dugan| Mary Dugan, a Broadway showgirl, is charged with murder in the knifing death of her wealthy lover, and goes on trial for her life. When her defense counsel appears to bungle his job, Marys...;
Lo spettro verde| On a dark foggy London night, someone tries to strangle Lord Montague, but he escapes. Only to discover the four other men who did get killed were old regimental comrades in Gallipoli. When...;
Lindomabile| When her rich oilman father is killed, Bingo, raised in the wilds of South America, inherits the company. Her guardians Ben and Howard send her to New York for civilizing but on the way she...;
The Vagabond Lover| A zany musical about an amateur musician in search of work who impersonates a big band leader.;
The Valiant| After killing an unknown man for an unknown reason, a mysterious drifter turns himself to the law, under a false name intending to protect his own familys honor. But when the news of his ...;
Verdun, visions dhistoire| Dramatic reenactment of the battle of Verdun during World War I, as seen by both French and German sides.;
Luomo della Virginia| A goodnatured cowboy who is romancing the new schoolmarm has a crisis of conscience when he discovers his best friend is engaged in cattle rustling.;
Giorni di giovent| Two friends try and court the same woman.;
La tragedia di Pizzo Pal| A man climbs a 12,000foot mountain to search for his wife, who was lost on their honeymoon. Another couple makes the dangerous climb with him.;
Evviva il pericolo| Harold Bledsoe, a botany student, is called back home to San Francisco, where his late father had been police chief, to help investigate a crime wave in Chinatown.;
Vendetta doriente| When an animal trapper in IndoChina finds that his daughters fianc is being successfully seduced by her estranged mother, he takes appropriate action.;
Why Be Good| A flapper with a dubious reputation enjoys a vivacious night of dancing and finds herself romantically linked to her boss.;
Orchidea selvaggia| A prince in Java tries to seduce his visitors wife, but hes discovered.;
Lallegra brigata| Wild girls at a college pay more attention to parties than their classes. But when one party girl, Stella Ames, goes too far at a local bar and gets in trouble, her professor has to rescue ...;
Nina Petrowna| Nina Petrovna, the mistress of a wealthy Cossack, falls in love with a young cadet. Their happiness is shortlived.;
La nuova generazione| Soapopera about a socialclimbing Jewish man and his oldworld parents who are heartbroken by his rejection of them.;
Il cavaliere della libert| An episodic biography of the 16th President of the United States.;
Allovest niente di nuovo| A German youth eagerly enters World War I, but his enthusiasm wanes as he gets a firsthand view of the horror.;
Animal Crackers| Mayhem and zaniness ensue when a valuable painting goes missing during a party in honor of famed African explorer Captain Spaulding.;
Anna Christie| A young woman reunites with her estranged father and falls in love with a sailor, but struggles to tell them about her dark past.;
Anna Christie| A young woman reunites with her estranged father and falls in love with a sailor, but struggles to tell them about her dark past.;
Il tempio delle tentazioni| Denise, an orphaned girl, moves to Paris where she hopes to find work at her uncles store. But the glamorous department store Aux Bonheur des Dames across the street crunches all the little businesses around. She finds a position there.;
Back Pay| Hester is bored with Gerald who loves her  bored with the Finley Department store  and bored with Demopolis. She leaves town with a traveling salesman named Bloom and the clothes on her ...;
The Bat Whispers| A master criminal terrorizes the occupants of an isolated country mansion.;
Be Yourself| Ethnic comedy of a nightclub entertainer trying to train a boxer.;
Beau Ideal| An American joins the French Foreign Legion in order to rescue a boyhood friend.;
The Benson Murder Case| A ruthless, crooked stockbroker is murdered at his luxurious country estate, and detective Philo Vance just happens to be there he decides to find out who killed him.;
Carcere| A convict falls in love with his new cellmates sister, only to become embroiled in a planned breakout which is certain to have lethal consequences.;
La conquista dellAmerica| A tour guide in Venice romances a visiting American tourist whose father owns a chewinggum factory back in the U.S. She sets out to convince her skeptical father to bring the tour guide to America and give him a job in the plant.;
Il grande sentiero| Breck Coleman leads hundreds of settlers in covered wagons from the Mississippi River to their destiny out West.;
Billy the Kid| In this version of the Billy the Kid legend, Billy, after shooting down land baron William Donovans henchmen for killing Billys boss, is hunted down and captured by his friend, Sheriff ...;
The Bishop Murder Case| When the body of a man nicknamed Cock Robin is found with an arrow in the heart on an archery range along with a chess bishop as a clue, Philo Vance investigates.;
Langelo azzurro| An elderly professors ordered life spins dangerously out of control when he falls for a nightclub singer.;
Borderline| A negro woman having an adulterous affair with a white man causes his wife to go mad and reenforces the townsfolks prejudice against Negroes.;
Temerario nato| Hoping to use the publicity to get reelected, a judge sentences a notorious gangster to fight in the war.;
Bright Lights| A successful Broadway star ready to retire from her wild career announces her engagement. But her tumultuous past isnt done with her yet.;
La sivigliana| From a poor working class background, Juan de Dios is a cantina performer in Seville, singing and dancing with his partner Lola. They have a contentious professional and personal ...;
Captain Thunder| Victor Varconi plays a charming Mexican bandit gets involved in several conflicting paradoxical relations, including an alliance with a crooked rival bandit and a beautiful daughter of the governor.;
Charleys Aunt| Charley Wyckham and Jack Chesney pressure fellow student Fancourt Babberly to pose as Charleys Brazilian Aunt Donna Lucia. Their purpose is to have a chaperone for their amorous visits ...;
Check and Double Check| Typical Amos n Andy storyline has the boys trying to make a go of their openair taxi business while they get caught up in a society hassle, involving driving musicians to a fancy party....;
Children of Pleasure| Successful songwriter falls for society girl who is just playing around. He doesnt realize that his girlFriday is the one he really loves until it is almost too late. Although he is ...;
Il nostro pane quotidiano| A Chicago waitress falls in love with a Minnesota farmer, and decides to face a life in the country.;
Conspiracy| For the last four years Margaret Holt has been helping her brother, assistant D.A. Victor Holt, to try to bring down the dope dealing Schemer Marko gang. Margaret kills Marko aka James ...;
A Cottage on Dartmoor| A former barber escapes from a high security prison. Flashback story of an escape from the lonely, highsecurity Dartmoor Prison.;
The Cuckoos| Two phony fortune tellers get mixed up with gypsies.;
Nella morsa delle rotaie| The tough boss of a railroad yard befriends a young hobo, and unwittingly places in jeopardy his relationship with the woman he loves.;
La beffa della vita| David is a poor but ambitious Polish Jew who reinvents himself as a powerful New York business magnate. After gaining wealth, he relocates to Paris, only to have his selfish and demanding wife squander his fortune.;
La squadriglia dellaurora| World War I ace Dick Courtney derides the leadership of his superior officer, but Courtney is soon promoted to squadron commander and learns harsh lessons about sending subordinates to their deaths.;
The Devil to Pay| Spendthrift Willie Leyland again returns to the family home in London penniless. His father is none too pleased but Willie smoothtalks him into letting him stay. At the same time he turns ...;
The Devils Holiday| A savvy city girl is hired to sugar an earnest farm boy into a business deal, but loses her heart.;
La divorziata| When a woman discovers that her husband has been unfaithful to her, she decides to respond to his infidelities in kind.;
Dixiana| In antebellum New Orleans, two men vie for the affections of a beautiful young girl during Mardi Gras.;
The Doorway to Hell| Despite his efforts to go straight, a young gangster keeps falling back into crime.;
Il guerriero| A naive and wealthy young man seeks to impress a girl and then unwittingly signs up for army service.;
La sirenetta dellautostrada| Willy, Kurt and Hans are broke, so they sell their car and open a filling station. Then they all fall in love with the same girl.;
Parla elstree| A series of nineteen musical and comedy vaudeville sketches presented in the form of a live broadcast hosted by Tommy Handley as himself. There are two running gags which connect the ...;
Extravagance| Alice Kendall is the darling of her social set, the sons and daughters of millionaires, although Alices mother has impoverished herself to provide Alice with the luxuries she expects as ...;
The Fall Guy| When a hapless pharmacist loses his job and falls in with criminals, hes soon made The Fall Guy. Unemployed, Johnny Quinlan Jack Mulhall starts doing jobs for underworld chieftain Nifty ...;
Fast and Loose| A wealthy family is thrown into turmoil when the daughter falls for the family chauffeur and the son begins to keep company with a chorus girl.;
The Menace| Ronald Quayle escapes from prison. He was sent there for murdering his father, based on the testimony of his stepmother, Caroline. An explosion disfigures him, but plastic surgery gives him...;
Piano coi piedi| An ambitious shoe salesman unknowingly meets his boss daughter and tells her he is a leather tycoon, then has to try to hide his true circumstances.;
The Flirting Widow| Phyllis wants to marry Bobby, but Father wont permit it until older sister Celia weds. So Celia invents a military fiance in Arabia, unimaginatively christens him John Smith, writes him a...;
Ragazze e giovanotti del 1890| The married friends of a New York chorus girl encourage her to pursue a handsome but poor socialite.;
Follow Thru| Lora Moore, the club champion, loses a golf match to a woman from another golf club. Then Jerry Downs, a handsome golf pro, and his goofy friend, Jack Martin, show up. Lora takes him on as ...;
For the Defense| William Powell plays William Foster, a slick attorney who stays within the law, but specializes in representing crooks and shady characters. Hes adept at keeping them out of jail, winning ...;
Framed| Woman swears revenge against an Inspector who was responsible for her fathers death.;
Chi non cerca... trova| A bumbling manager tries to get a small town beauty contest winner into the movies.;
Come rubai mia moglie| A brash, pushy young man gets a job in a bank and sets his cap for his bosss secretary, but the death of his father makes him reassess his priorities.;
Going Wild| Rollo and Lane just happen to be tossed off the train at White Beach where Robert Story Air ace and writer is supposed to stop. It is a case of mistaken identity as no one knows what ...;
Golden Dawn|  NA;
Good News| Tom Marlowe is the star of his college football team, and has a promising romance with a female college student, Connie Lane. He does not excel, however, in his college studies. A series of...;
La dea verde| An airplane carrying three BritsMajor Crespin, his wife Lucille, and Dr. Traherncrash lands in the kingdom of Rukh. The Rajah holds them prisoner because the British are about to ...;
Half Shot at Sunrise| The stage stars Wheeler and Woolsey play two soldiers who go absent without leave in Paris, during World War I.;
Giorni felici| Margie, singer on a showboat, decides to try her luck in New York inspite of being in love with the owners grandson. She is successful, but suddenly she hears that the showboat is in deep ...;
Il porto dellinferno| Lovely Anita dreams of escaping the monotony of her island home and sailing to bustling Havana. But when her abusive father promises her to the greasy local merchant, Anita does everything in her power to make her dream a reality.;
Gli angeli dellinferno| Brothers Monte and Ray leave Oxford to join the Royal Flying Corps. Ray loves Helen Helen enjoys an affair with Monte before they leave on their mission over Germany they find her in still another mans arms.;
La stella della Taverna Nera| Havana bar girl with tough protector falls for young sailor.;
Passeggiate allegramente| A smalltime hood wants to go straight for a good girl but finds that starting over isnt as simple as it sounds.;
Holiday| Holiday is a 1930 American PreCode romantic comedy film which tells the story of a young man who is torn between his freethinking lifestyle and the tradition of his wealthy fiances family.;
Hook Line and Sinker| Two fasttalking insurance salesmen meet Mary, who is running away from her wealthy mother, and they agree to help her run a hotel that she owns. When they find out that the hotel is run ...;
Inside the Lines| During World War 1, German spies will stop at nothing to spy on the allied war plans stored at Gibraltar.;
Journeys End| In France, 1917, an alcoholic captain is afraid that his new replacement, his sweethearts brother, will betray his downfall.;
I prodigi del 2000| New York, 1980 airplanes have replaced cars, numbers have replaced names, pills have replaced food, governmentarranged marriages have replaced love, and test tube babies have replaced ......;
Il re del jazz| American PreCode color film starring Paul Whiteman and his Jazz orchestra.;
Femmine di lusso| An uppercrust artist hires a party girl as a model romance follows.;
The Lady of Scandal| A famous British actress gets involved with two members of a reserved British noble family, whose plan to get rid of her backfires.;
Notte di peccato| Middleaged Napa Valley grapegrower Tony posts a marriage proposal to San Francisco waitress Lena enclosing a photo of his handsome younger brother Buck. When she gets there she overlooks ...;
La sferzata| Don Francisco Delfina, a nobleman of Southern California in 1848, disguises himself as El Puma and leads a revolt against the tyrannical land agent and politician Peter Harkness.;
Laughter| A former chorus girl weds a millionaire after the composer she loves leaves. Meanwhile, she strings along an artist in love with her. When the composer returns, she struggles with her needs for security vs love. High jinks and drama ensue.;
La moglie bella| Dowdy housewife Kitty dotes on her selfcentered husband but divorces him when his mistress shows up at their home one day to break up their marriage. Bob had become bored with her ...;
Nel regno della fantasia| Dress designer Joan Wood, whos heavily in debt, has created costumes for a Broadway show that is exported to Argentina. With the money she wants to pay her debts, but there was a mistake ...;
The Life of the Party| Two attractive female songpluggers decide to become golddiggers, with comic results.;
The Light of Western Stars| A friend of Dick Bailey is killed by a mysterious assailant, whom Dick suspects to be Stack, who is in league with the crooked sheriff. Out on a spree Dick swears he will marry the first ...;
La leggenda di Liliom| Liliom, a merrygoround barker at a Budapest amusement park, becomes enamored of Julie, a servant girl, and though under the influence of Madame Muskat, a sideshow entrepreneur, he marries...;
Piccolo Cesare| A smalltime criminal moves to a big city to seek bigger fortune.;
Loose Ankles| In this light romantic comedy, 17year old Loretta Young is cast as Ann Harper, a wealthy socialite who has inherited a fortune provided the family is involved in no scandals appearing in ...;
Lord Byron of Broadway| A tunesmith, a user and an outandout heel, puts the stories of his broken romances into song, turning old love letters into lyrics, and capitalizing on the death of his best friend to ...;
The PayOff| A thug robs a young engaged couple of their last few dollars. When the thugs gang boss hears of the robbery, he gives them back their money and takes them under his wing. The thug, ...;
La moglie n. 66| Sundered lovers meet again amid tragic irony at a mining camp in northern Norway.;
Love in the Rough| When shipping clerk Jack Kelly is recruited by his employer to help his golf game, his boss insists he conceal his humble identity at the country club.;
Lovin the Ladies| Jimmy Farnsworth Allen Kearns bets his friend 5,000 that he can get any two people, under the proper environment, to fall in love and become engaged within a month.;
Madame Satan| Angela and Bob Brooks are an upper class couple. Unfortunately, Bob is an unfaithful husband. But Angela has a plan to win back her husbands affections. An elaborate masquerade ball is to ...;
Nomadi del canto| A love triangle develops in a traveling minstrel troupe.;
Manslaughter| A spoiled young rich girl is sent to prison for accidentally running down a pedestrian. There she learns about a life and people she had never even imagined existed before. Upon her release...;
Mary| A juror in a murder trial, after voting to convict, has second thoughts and begins to investigate on his own before the execution.;
The Matrimonial Bed| It is the fifth anniversary of the death of Adolphe Noblet who died in a train wreck. His servant and friends still worship him but dont care much for his wife Sylvaines second husband ...;
Maybe Its Love| A college football player Joe E. Brown persuades a beautiful young woman Joan Bennett to individually flirt with an entire team of AllAmerican football players, in order to entice them...;
The Medicine Man| The son and daughter of an abusive shopkeeper turn to a medicine show salesman for help.;
Il sottomarino| Navy divers clear the torpedo tube of a sunken submarine.;
Castigo| Min, the owner of a dockside hotel, is forced to make difficult decisions about the future of Nancy, the young woman she took in as an infant.;
Moby Dick il mostro bianco| In this extremely loose adaptation of Melvilles classic novel, Ahab is revealed initially not as a bitter and vengeful madman, but as a bit of a lovable scamp. Ashore in New Bedford, he ...;
Un marito fuori posto| A vacuous and flirtatious daughter of a wealthy rancher falls in love and marries a Texas cowboy and rancher, who calls her Montana, and eventually clash over their different lifestyles, to the point of almost ending their marriage.;
Monte Carlo| A countess flees to Monte Carlo on the day of her wedding, where she is courted by a count posing as a hairdresser.;
Marocco| A cabaret singer and a Legionnaire fall in love, but their relationship is complicated by the results of his womanizing and due to the appearance of a rich man who wants her for himself.;
Omicidio| A juror in a murder trial, after voting to convict, has second thoughts and begins to investigate on his own before the execution.;
Passione cosacca| New Moon is the name of the ship crossing the Caspian Sea. A young Lt. Petroff meets the Princess Tanya and they have a ship board romance. Upon arriving at the port of Krasnov, Petroff ...;
Gabbia di matti| Notsosmart chatterbox Dulcy Parker does and says all the wrong things, but they right themselves to prove shes not so dumb after all.;
La donna e la femmina| A scheming musician seduces a wealthy woman for love and money.;
La dattilografa| Larry Fellowes of Fellowes Publishing wants Kate to write her next book about the Office Wife. The personal secretarystenographer spends more time with the busy executive and makes more ...;
One Night at Susies| A woman who owns a boarding house winds up being the mother hen to the assorted mobsters and racketeers who live there. When her foster son decides to take the blame for a murder that was...;
Notte romantica| A scheming mother wishes to make a succesful match between her daughter and a prince, yet another man, a commoner, may stand in the way.;
Ragazze che sognano| Three department store girlsConnie, Franky, and Jerryshare an apartment on West 91st Street in New York City. Each earns little more than 20 dollars per week. Jerry is the sensible one,...;
Outside the Law| Fingers is planning a halfmilliondollar bank robbery in gang boss Cobra Collins territory. Fingers moll Connie tries to bluff Cobra into thinking the hit wont be for another week when the call comes through saying its now.;
Outward Bound| Later remade as Between Two Worlds.;
Debito dodio| Mary Turner goes up for three years on a crime she didnt commit. Once out she and former prison mates plan a scam in which old men can be sued for breach of promise  the heart balm ...;
Paramount revue| A musical revue that basically has Paramount stars and contractplayers doing things some had never done on screen, and wouldnt again such as Ruth Chatteron , in a Frenchcaf setting ...;
Party Girl| Jay Rountree, son of a wealthy manufacturer and young, rising businessman, gets caught up in a web involving an escort service or party girls. While eluding the wily Diana Holster, the ...;
Passion Flower| A bored society woman invites scandal and heartache when she falls in love with her lowborn chauffeur.;
La petite Lise| Victor Berthier, a good man but also a very jealous one, killed his wife in a fit of jealousy. After serving a few years in a chain gang, he is released for good behavior. He feels very ...;
Vertigine del lusso| New York girl has a dull boyfriend and seems destined for a dull marriage when she meets a rich playboy who has money to burn and places to go. She gets involved with the playboy and never ...;
Prazdnik svyatogo Yorgena| Satire of religious charlatanry where priests, police, and stock market officials conspire to fleece pilgrims whove come to see relics of a supposed saint. A pair of con men hatch a scheme...;
Miss Europa| Lucienne, typist and gorgeous bathing beauty, decides to enter the Miss Europe pageant sponsored by the French newspaper she works for. She finds her jealous lover Andre violently ...;
Vertigine| A vaudeville and nightclub performer becomes successful and forgets who his friends really are.;
Una notte celestiale| A poor but basically honest flower woman agrees to impersonate a wicked opera star.;
Raffles| A distinguished English gentleman has a secret lifehe is the notorious jewel thief the press has dubbed The Amateur Cracksman. When he meets a woman and falls in love he decides to ...;
Luci del circo| Woman inherits a traveling circus which brings financial difficulties.;
Sono stato bocciato ma...| A story of a college student Tatsuo Sait and his schoolmates trying to pass the exams by cheating.;
Reaching for the Moon| Wall Street wizard, Larry Day, new to the ways of love, is coached by his valet. He follows Vivian Benton on an ocean liner, where cocktails, laced with a love potion, work their magic. ...;
Redenzione| Fedya wins Lisa away from her fiance, Victor Karenin. But after Fedya weds Lisa, he becomes infatuated with a gypsy girl, Masha. His duplicity leads to tragedy.;
La banda dei fantasmi| A radio announcer suspects a cohort sends coded messages over the air to his bankrobber friends.;
La spia| Four oneforall and allforone privates in the French Foreign Legion are all in jail for disorderly conduct, but they break out and rejoin their regiment and fight off a band of marauding...;
The Return of Dr. Fu Manchu| The villainous master criminal Dr. Fu Manchu sets out to destroy the people he holds responsible for the death of his family.;
Rivers End| Sgt. Conniston and his alcoholic guide OToole are on the trail of an escaped murderer named Keith. When they catch up with him in the farthest reaches of Northern Canada, Keith turns out ...;
Dallombra alla luce| A young girl falls in with a gang of criminals. One of their capers is robbing the house of a wealthy socialite who happens to look just like her. In the process of cleaning out the house, ...;
Amor gitano| In tsarist Russia, a princess falls for a dashing bandit leader, but their romance proves a stormy one.;
Una volpe a corte| When Renard the Foxs mischievous pranks go too far, King Lion is forced to attempt to bring the trickster to justice.;
Romanzo| Young Harry is in love and wants to marry an actress, much to the displeasure of his family. Harry thinks that Bishop Armstrong knows nothing about love so Armstrong tells him the story of ...;
La famiglia reale di Broadway| Julie Cavendish comes from a family of great Broadway actors. Her mother Fanny staunchly continues acting. Her boisterous brother Tony is fleeing a breach of promise suit in Hollywood. Her ...;
Runaway Bride| A young socialite and a rich playboy elope to Atlantic City. However, she soon realizes hes not the man she wants him to be and tries to call off the wedding. A jewelry store robbery, murder and other mayhem are soon involved.;
Le sang dun pote| A young artist draws a face at a canvas on his easel. Suddenly the mouth on the drawing comes into life and starts talking. The artist tries to wipe it away with his hand, but when he looks...;
Sarah and Son| A neerdowell husband, after years of abusing his wife, disappears with their son, and winds up selling him to a wealthy family. Years later, the wifenow a worldfamous opera singer...;
Il vampiro del mare| The West Indies island of Portuga exists mainly for sponge diving. But the best area of collection is frequented by a very large manta ray. Nina loses her brother to the creature and is ...;
La crociera del folle| On a yacht sailing from Shanghai to the United States, the sailors, led by the megalomaniac steward, revolt and take control.;
Show Girl in Hollywood| Rainbow Girls has just opened and closed on Broadway when Dixie, a actress in it, runs into smooth talking Hollywood Director Frank Buelow. He tells her she would be a natural, promises ...;
The Silver Horde| A salmon fisherman has to choose between a bad girl and a society doll.;
The Sin Ship| A lecherous ship captain becomes spiritually changed by a female passenger, not realizing she and her minister husband are really bank robbers.;
Sin Takes a Holiday| A plain secretary works for a womanizing divorce lawyer who only dates married women. To avoid having to deal with the matrimonial pursuits of any of his potential romances, he offers her financial support if she marries him in name only.;
La vacanza del peccatore| Ma Delano La Verne runs a boardwalk penny arcade, living upstairs with her sons Cagney and Gallagher and daughter Knapp. Story involves rum running, accidental murder and a frameup.;
Ombre e luci| A German immigrant to a small American town is a barber with four children. He has saved enough money to invest in a savingsandloan company with a friend. Unfortunately, one of his sons ...;
So Long Letty| Uncle Claude comes to the Ardmore Beach Hotel to see Tommy and his wife. At the hotel, with his two granddaughters Ruth and Sally, Uncle Claude meets a wise talking employee named Letty ...;
Sam Lee principe cinese| A Chinese posing as an American goes to Monte Carlo where he falls in love with Alanna, who later goes berserk upon learning his true identity.;
Song o My Heart| Broken hearts in Ireland. Sean is a great tenor, in semiretirement, living in a village close to Mary, the woman hes always loved. Marys aunt convinced her to marry a man for his money ...;
La moglie di quella notte| A desperate man with a sick daughter decides to commit a robbery in order to help her. He begins to feel remorse though, which makes him question his decision.;
Soup to Nuts| Mr. Schmidts costume store is bankrupt because he spends his time on Rube Goldbergstyle inventions. The creditors send a young manager who falls for Schmidts niece Louise, but shell ...;
Sotto i tetti di Parigi| Albert is smitten for Pola but ends up wrongly committed in jail, in the meantime her affections are sought after by his friend, and on his release both love and friendship must be tested.;
Spring Is Here| Betty a young woman is going steady with Terry but falls for an exciting new comer to town Steve. Bettys father wants her to marry Terry but she doesnt see that she actually is in love ...;
Street of Chance| A bigtime, but honest gambler has to prevent his younger brother from following in his footsteps, and taking up gambling.;
Sunny| To be near the fella she loves, an English bareback rider dons dungarees and cap to pass as a boy stows away to America, gets caught, marries someone else...and finally ends up in the warm ...;
Sweet Kitty Bellairs| In 1793, Kitty Bellairs travels to Bath, Somerset for a vacation. She is a famous flirt, with about 40 previous affairs. Her coach wagon is stopped by a highwayman, but the man falls in ...;
The Texan| An outlaw, the Llano Kid is the scourge of south Texas and a Bible quoting lawman named Thacker. The kid joins a con man in a plot to deceive a wealthy old woman that hes her longlost son...;
They Learned About Women| When Jack and Jerry are not playing professional baseball with the Blue Sox, they are packing them in on the Vaudeville circuit. Jack is engaged to Mary, but a gold digger named Daisy has ...;
Agente segreto Z1| A beautiful British intelligence agent attempts to reveal the identity and motives of a powerful German spy during World War 1.;
Tom Sawyer| The classic Mark Twain tale of a young boy and his friends on the Mississippi River. Tom and his pals Huckleberry Finn and Joe Harper have numerous adventures, including running away to be ...;
Tonka Sibenice| A prostitute in an act of pity is keeping chaste company with a condemned man through the night before he is to be hung.;
Top Speed| An order clerk poses as a millionaire.;
True to the Navy| A countergirl at a San Diego soda shop has a lot of sailor boyfriends, but her heart really belongs to a freespirited gunner, who doesnt want to be tied down to any one woman.;
The Truth About Youth| Richard Carewe has raised his deceased friends son from childhood with the help of his housekeeper and her beautiful daughter, Phyllis. He arranges a marriage between Phyllis and the boy, ...;
The Unholy Three| Talkie remake of Tod Brownings 1925 silent film. A trio of former sideshow performers double as the Unholy Three in a scam to nab some shiny rocks.;